year,county,B25003_001E,B25003_002E,B25003_003E,state,county 1
01/01/2016 12:00:00 AM,"Prince William County, Virginia",138102,98292,39810,51,153
01/01/2016 12:00:00 AM,"Pulaski County, Virginia",14553,10455,4098,51,155
01/01/2016 12:00:00 AM,"Rappahannock County, Virginia",3247,2412,835,51,157
01/01/2016 12:00:00 AM,"Richmond County, Virginia",3084,2259,825,51,159
01/01/2015 12:00:00 AM,"Accomack County, Virginia",13961,9919,4042,51,001
01/01/2015 12:00:00 AM,"Albemarle County, Virginia",38853,25281,13572,51,003
01/01/2015 12:00:00 AM,"Alleghany County, Virginia",6781,5337,1444,51,005
01/01/2015 12:00:00 AM,"Amelia County, Virginia",4704,3824,880,51,007
01/01/2015 12:00:00 AM,"Amherst County, Virginia",12502,9534,2968,51,009
01/01/2016 12:00:00 AM,"Roanoke County, Virginia",38322,28492,9830,51,161
01/01/2015 12:00:00 AM,"Appomattox County, Virginia",5931,4794,1137,51,011
01/01/2016 12:00:00 AM,"Rockbridge County, Virginia",9277,7176,2101,51,163
01/01/2016 12:00:00 AM,"Rockingham County, Virginia",29883,22148,7735,51,165
01/01/2015 12:00:00 AM,"Arlington County, Virginia",98441,43697,54744,51,013
01/01/2015 12:00:00 AM,"Augusta County, Virginia",28150,22341,5809,51,015
01/01/2015 12:00:00 AM,"Bath County, Virginia",2146,1495,651,51,017
01/01/2016 12:00:00 AM,"Russell County, Virginia",10937,8505,2432,51,167
01/01/2015 12:00:00 AM,"Bedford County, Virginia",30591,24850,5741,51,019
01/01/2016 12:00:00 AM,"Scott County, Virginia",9104,6982,2122,51,169
01/01/2016 12:00:00 AM,"Shenandoah County, Virginia",17222,12189,5033,51,171
01/01/2016 12:00:00 AM,"Smyth County, Virginia",12930,9061,3869,51,173
01/01/2015 12:00:00 AM,"Bland County, Virginia",2614,2089,525,51,021
01/01/2016 12:00:00 AM,"Southampton County, Virginia",6727,4610,2117,51,175
01/01/2015 12:00:00 AM,"Botetourt County, Virginia",12913,11314,1599,51,023
01/01/2016 12:00:00 AM,"Spotsylvania County, Virginia",43105,33249,9856,51,177
01/01/2015 12:00:00 AM,"Brunswick County, Virginia",5916,4319,1597,51,025
01/01/2015 12:00:00 AM,"Buchanan County, Virginia",9442,7449,1993,51,027
01/01/2016 12:00:00 AM,"Stafford County, Virginia",44311,33330,10981,51,179
01/01/2016 12:00:00 AM,"Surry County, Virginia",2707,2212,495,51,181
01/01/2016 12:00:00 AM,"Sussex County, Virginia",3793,2456,1337,51,183
01/01/2015 12:00:00 AM,"Buckingham County, Virginia",5603,4347,1256,51,029
01/01/2016 12:00:00 AM,"Tazewell County, Virginia",17595,13208,4387,51,185
01/01/2016 12:00:00 AM,"Warren County, Virginia",14174,10737,3437,51,187
01/01/2015 12:00:00 AM,"Campbell County, Virginia",21791,16572,5219,51,031
01/01/2016 12:00:00 AM,"Washington County, Virginia",22512,17178,5334,51,191
01/01/2016 12:00:00 AM,"Westmoreland County, Virginia",7124,5510,1614,51,193
01/01/2016 12:00:00 AM,"Wise County, Virginia",15225,10447,4778,51,195
01/01/2016 12:00:00 AM,"Wythe County, Virginia",12039,8643,3396,51,197
01/01/2016 12:00:00 AM,"York County, Virginia",23872,17207,6665,51,199
01/01/2016 12:00:00 AM,"Alexandria city, Virginia",68063,28710,39353,51,510
01/01/2016 12:00:00 AM,"Bristol city, Virginia",7671,4423,3248,51,520
01/01/2015 12:00:00 AM,"Caroline County, Virginia",10970,8855,2115,51,033
01/01/2016 12:00:00 AM,"Buena Vista city, Virginia",2709,1608,1101,51,530
01/01/2015 12:00:00 AM,"Carroll County, Virginia",12548,9915,2633,51,035
01/01/2015 12:00:00 AM,"Charles City County, Virginia",2883,2344,539,51,036
01/01/2016 12:00:00 AM,"Charlottesville city, Virginia",17980,7579,10401,51,540
01/01/2016 12:00:00 AM,"Chesapeake city, Virginia",82573,57851,24722,51,550
01/01/2016 12:00:00 AM,"Colonial Heights city, Virginia",7206,4350,2856,51,570
01/01/2015 12:00:00 AM,"Charlotte County, Virginia",4723,3281,1442,51,037
01/01/2016 12:00:00 AM,"Covington city, Virginia",2472,1856,616,51,580
01/01/2015 12:00:00 AM,"Chesterfield County, Virginia",116797,89151,27646,51,041
01/01/2015 12:00:00 AM,"Clarke County, Virginia",5526,4195,1331,51,043
01/01/2015 12:00:00 AM,"Craig County, Virginia",2214,1794,420,51,045
01/01/2016 12:00:00 AM,"Danville city, Virginia",18653,10065,8588,51,590
01/01/2016 12:00:00 AM,"Emporia city, Virginia",2210,873,1337,51,595
01/01/2016 12:00:00 AM,"Fairfax city, Virginia",8476,5992,2484,51,600
01/01/2016 12:00:00 AM,"Falls Church city, Virginia",5301,3162,2139,51,610
01/01/2016 12:00:00 AM,"Franklin city, Virginia",3424,1703,1721,51,620
01/01/2016 12:00:00 AM,"Fredericksburg city, Virginia",10271,3575,6696,51,630
01/01/2015 12:00:00 AM,"Culpeper County, Virginia",16515,12023,4492,51,047
01/01/2016 12:00:00 AM,"Galax city, Virginia",2767,1564,1203,51,640
01/01/2015 12:00:00 AM,"Cumberland County, Virginia",4012,2893,1119,51,049
01/01/2016 12:00:00 AM,"Hampton city, Virginia",53656,30150,23506,51,650
01/01/2015 12:00:00 AM,"Dickenson County, Virginia",6205,4805,1400,51,051
01/01/2016 12:00:00 AM,"Harrisonburg city, Virginia",16626,6224,10402,51,660
01/01/2015 12:00:00 AM,"Dinwiddie County, Virginia",9939,7617,2322,51,053
01/01/2016 12:00:00 AM,"Hopewell city, Virginia",8866,4444,4422,51,670
01/01/2015 12:00:00 AM,"Essex County, Virginia",4332,3189,1143,51,057
01/01/2016 12:00:00 AM,"Lexington city, Virginia",1856,1042,814,51,678
01/01/2015 12:00:00 AM,"Fairfax County, Virginia",392355,265693,126662,51,059
01/01/2016 12:00:00 AM,"Lynchburg city, Virginia",28282,14291,13991,51,680
01/01/2015 12:00:00 AM,"Fauquier County, Virginia",23595,18674,4921,51,061
01/01/2016 12:00:00 AM,"Manassas city, Virginia",12430,7727,4703,51,683
01/01/2015 12:00:00 AM,"Floyd County, Virginia",6271,4872,1399,51,063
01/01/2016 12:00:00 AM,"Manassas Park city, Virginia",4730,3112,1618,51,685
01/01/2016 12:00:00 AM,"Martinsville city, Virginia",5787,3061,2726,51,690
01/01/2016 12:00:00 AM,"Newport News city, Virginia",69247,34240,35007,51,700
01/01/2016 12:00:00 AM,"Norfolk city, Virginia",87367,37396,49971,51,710
01/01/2015 12:00:00 AM,"Fluvanna County, Virginia",9891,8124,1767,51,065
01/01/2016 12:00:00 AM,"Norton city, Virginia",1858,842,1016,51,720
01/01/2015 12:00:00 AM,"Franklin County, Virginia",23189,17950,5239,51,067
01/01/2016 12:00:00 AM,"Petersburg city, Virginia",13175,5429,7746,51,730
01/01/2015 12:00:00 AM,"Frederick County, Virginia",29455,23010,6445,51,069
01/01/2016 12:00:00 AM,"Poquoson city, Virginia",4610,3830,780,51,735
01/01/2015 12:00:00 AM,"Giles County, Virginia",7230,5499,1731,51,071
01/01/2016 12:00:00 AM,"Portsmouth city, Virginia",36840,19820,17020,51,740
01/01/2015 12:00:00 AM,"Gloucester County, Virginia",14280,11282,2998,51,073
01/01/2016 12:00:00 AM,"Radford city, Virginia",5604,2451,3153,51,750
01/01/2016 12:00:00 AM,"Richmond city, Virginia",88958,36829,52129,51,760
01/01/2016 12:00:00 AM,"Roanoke city, Virginia",42541,22157,20384,51,770
01/01/2016 12:00:00 AM,"Salem city, Virginia",10060,6464,3596,51,775
01/01/2015 12:00:00 AM,"Goochland County, Virginia",8148,7088,1060,51,075
01/01/2016 12:00:00 AM,"Staunton city, Virginia",10383,6028,4355,51,790
01/01/2015 12:00:00 AM,"Grayson County, Virginia",6795,5059,1736,51,077
01/01/2015 12:00:00 AM,"Greene County, Virginia",7111,5512,1599,51,079
01/01/2016 12:00:00 AM,"Suffolk city, Virginia",31741,21992,9749,51,800
01/01/2015 12:00:00 AM,"Greensville County, Virginia",3486,2495,991,51,081
01/01/2016 12:00:00 AM,"Virginia Beach city, Virginia",167509,105833,61676,51,810
01/01/2015 12:00:00 AM,"Halifax County, Virginia",14300,10344,3956,51,083
01/01/2016 12:00:00 AM,"Waynesboro city, Virginia",9044,5237,3807,51,820
01/01/2015 12:00:00 AM,"Hanover County, Virginia",37463,30348,7115,51,085
01/01/2016 12:00:00 AM,"Williamsburg city, Virginia",4627,2157,2470,51,830
01/01/2015 12:00:00 AM,"Henrico County, Virginia",124589,78341,46248,51,087
01/01/2016 12:00:00 AM,"Winchester city, Virginia",10596,4822,5774,51,840
01/01/2015 12:00:00 AM,"Henry County, Virginia",22415,16711,5704,51,089
01/01/2016 12:00:00 AM,"Accomack County, Virginia",13819,9605,4214,51,001
01/01/2015 12:00:00 AM,"Highland County, Virginia",1071,883,188,51,091
01/01/2016 12:00:00 AM,"Albemarle County, Virginia",39431,25584,13847,51,003
01/01/2016 12:00:00 AM,"Alleghany County, Virginia",6845,5396,1449,51,005
01/01/2015 12:00:00 AM,"Isle of Wight County, Virginia",13769,10749,3020,51,093
01/01/2015 12:00:00 AM,"James City County, Virginia",28000,20984,7016,51,095
01/01/2016 12:00:00 AM,"Amelia County, Virginia",4540,3845,695,51,007
01/01/2016 12:00:00 AM,"Amherst County, Virginia",12306,9434,2872,51,009
01/01/2015 12:00:00 AM,"King and Queen County, Virginia",2894,2196,698,51,097
01/01/2016 12:00:00 AM,"Appomattox County, Virginia",5972,4757,1215,51,011
01/01/2015 12:00:00 AM,"King George County, Virginia",8379,6120,2259,51,099
01/01/2015 12:00:00 AM,"King William County, Virginia",6036,4931,1105,51,101
01/01/2015 12:00:00 AM,"Lancaster County, Virginia",5164,3874,1290,51,103
01/01/2015 12:00:00 AM,"Lee County, Virginia",9445,6906,2539,51,105
01/01/2015 12:00:00 AM,"Loudoun County, Virginia",113432,87461,25971,51,107
01/01/2015 12:00:00 AM,"Louisa County, Virginia",12829,10204,2625,51,109
01/01/2015 12:00:00 AM,"Lunenburg County, Virginia",4516,3326,1190,51,111
01/01/2015 12:00:00 AM,"Madison County, Virginia",5003,3635,1368,51,113
01/01/2015 12:00:00 AM,"Mathews County, Virginia",3806,3152,654,51,115
01/01/2015 12:00:00 AM,"Mecklenburg County, Virginia",12482,9242,3240,51,117
01/01/2016 12:00:00 AM,"Arlington County, Virginia",100707,44531,56176,51,013
01/01/2015 12:00:00 AM,"Middlesex County, Virginia",4342,3613,729,51,119
01/01/2016 12:00:00 AM,"Augusta County, Virginia",28425,22601,5824,51,015
01/01/2016 12:00:00 AM,"Bath County, Virginia",2104,1430,674,51,017
01/01/2016 12:00:00 AM,"Bedford County, Virginia",30821,25056,5765,51,019
01/01/2016 12:00:00 AM,"Bland County, Virginia",2561,2107,454,51,021
01/01/2016 12:00:00 AM,"Botetourt County, Virginia",13305,11442,1863,51,023
01/01/2015 12:00:00 AM,"Montgomery County, Virginia",35199,19093,16106,51,121
01/01/2016 12:00:00 AM,"Brunswick County, Virginia",6148,4391,1757,51,025
01/01/2015 12:00:00 AM,"Nelson County, Virginia",6339,4568,1771,51,125
01/01/2016 12:00:00 AM,"Buchanan County, Virginia",9124,7163,1961,51,027
01/01/2016 12:00:00 AM,"Buckingham County, Virginia",5689,4351,1338,51,029
01/01/2015 12:00:00 AM,"New Kent County, Virginia",7299,6240,1059,51,127
01/01/2016 12:00:00 AM,"Campbell County, Virginia",22294,16897,5397,51,031
01/01/2015 12:00:00 AM,"Northampton County, Virginia",5248,3614,1634,51,131
01/01/2015 12:00:00 AM,"Northumberland County, Virginia",5861,4906,955,51,133
01/01/2015 12:00:00 AM,"Nottoway County, Virginia",5589,3651,1938,51,135
01/01/2015 12:00:00 AM,"Orange County, Virginia",12810,9669,3141,51,137
01/01/2016 12:00:00 AM,"Caroline County, Virginia",10965,8523,2442,51,033
01/01/2015 12:00:00 AM,"Page County, Virginia",9372,6596,2776,51,139
01/01/2016 12:00:00 AM,"Carroll County, Virginia",12642,9849,2793,51,035
01/01/2016 12:00:00 AM,"Charles City County, Virginia",2854,2350,504,51,036
01/01/2015 12:00:00 AM,"Patrick County, Virginia",7790,5974,1816,51,141
01/01/2015 12:00:00 AM,"Pittsylvania County, Virginia",26204,20121,6083,51,143
01/01/2015 12:00:00 AM,"Powhatan County, Virginia",9730,8499,1231,51,145
01/01/2015 12:00:00 AM,"Prince Edward County, Virginia",7409,4801,2608,51,147
01/01/2015 12:00:00 AM,"Prince George County, Virginia",11102,7835,3267,51,149
01/01/2015 12:00:00 AM,"Prince William County, Virginia",136794,97744,39050,51,153
01/01/2016 12:00:00 AM,"Charlotte County, Virginia",4594,3154,1440,51,037
01/01/2015 12:00:00 AM,"Pulaski County, Virginia",14619,10416,4203,51,155
01/01/2016 12:00:00 AM,"Chesterfield County, Virginia",118908,89857,29051,51,041
01/01/2015 12:00:00 AM,"Rappahannock County, Virginia",3273,2492,781,51,157
01/01/2015 12:00:00 AM,"Richmond County, Virginia",2875,2138,737,51,159
01/01/2016 12:00:00 AM,"Clarke County, Virginia",5591,4162,1429,51,043
01/01/2015 12:00:00 AM,"Roanoke County, Virginia",38164,28496,9668,51,161
01/01/2016 12:00:00 AM,"Craig County, Virginia",2314,1678,636,51,045
01/01/2015 12:00:00 AM,"Rockbridge County, Virginia",9319,6927,2392,51,163
01/01/2015 12:00:00 AM,"Rockingham County, Virginia",29625,22449,7176,51,165
01/01/2016 12:00:00 AM,"Culpeper County, Virginia",16904,12118,4786,51,047
01/01/2015 12:00:00 AM,"Russell County, Virginia",11045,8614,2431,51,167
01/01/2016 12:00:00 AM,"Cumberland County, Virginia",4085,2977,1108,51,049
01/01/2016 12:00:00 AM,"Dickenson County, Virginia",6055,4541,1514,51,051
01/01/2015 12:00:00 AM,"Scott County, Virginia",9379,7289,2090,51,169
01/01/2015 12:00:00 AM,"Shenandoah County, Virginia",17096,12417,4679,51,171
01/01/2015 12:00:00 AM,"Smyth County, Virginia",12795,8942,3853,51,173
01/01/2015 12:00:00 AM,"Southampton County, Virginia",6682,4656,2026,51,175
01/01/2016 12:00:00 AM,"Dinwiddie County, Virginia",10344,7800,2544,51,053
01/01/2015 12:00:00 AM,"Spotsylvania County, Virginia",42823,32589,10234,51,177
01/01/2016 12:00:00 AM,"Essex County, Virginia",4447,3177,1270,51,057
01/01/2015 12:00:00 AM,"Stafford County, Virginia",43405,33314,10091,51,179
01/01/2015 12:00:00 AM,"Surry County, Virginia",2668,2134,534,51,181
01/01/2015 12:00:00 AM,"Sussex County, Virginia",3149,2061,1088,51,183
01/01/2015 12:00:00 AM,"Tazewell County, Virginia",17832,13438,4394,51,185
01/01/2015 12:00:00 AM,"Warren County, Virginia",14364,11020,3344,51,187
01/01/2015 12:00:00 AM,"Washington County, Virginia",22673,17273,5400,51,191
01/01/2015 12:00:00 AM,"Westmoreland County, Virginia",6944,5179,1765,51,193
01/01/2016 12:00:00 AM,"Fairfax County, Virginia",393358,265351,128007,51,059
01/01/2015 12:00:00 AM,"Wise County, Virginia",15254,10627,4627,51,195
01/01/2016 12:00:00 AM,"Fauquier County, Virginia",23890,18660,5230,51,061
01/01/2015 12:00:00 AM,"Wythe County, Virginia",11863,8270,3593,51,197
01/01/2016 12:00:00 AM,"Floyd County, Virginia",6303,4903,1400,51,063
01/01/2015 12:00:00 AM,"York County, Virginia",23997,17512,6485,51,199
01/01/2016 12:00:00 AM,"Fluvanna County, Virginia",9829,7804,2025,51,065
01/01/2016 12:00:00 AM,"Franklin County, Virginia",22976,18209,4767,51,067
01/01/2016 12:00:00 AM,"Frederick County, Virginia",29914,23366,6548,51,069
01/01/2016 12:00:00 AM,"Giles County, Virginia",7290,5466,1824,51,071
01/01/2015 12:00:00 AM,"Alexandria city, Virginia",66879,28410,38469,51,510
01/01/2016 12:00:00 AM,"Gloucester County, Virginia",14511,11130,3381,51,073
01/01/2016 12:00:00 AM,"Goochland County, Virginia",8177,7033,1144,51,075
01/01/2015 12:00:00 AM,"Bristol city, Virginia",7718,4257,3461,51,520
01/01/2015 12:00:00 AM,"Buena Vista city, Virginia",2737,1605,1132,51,530
01/01/2015 12:00:00 AM,"Charlottesville city, Virginia",17752,7735,10017,51,540
01/01/2015 12:00:00 AM,"Chesapeake city, Virginia",81518,57374,24144,51,550
01/01/2015 12:00:00 AM,"Colonial Heights city, Virginia",7106,4461,2645,51,570
01/01/2016 12:00:00 AM,"Grayson County, Virginia",6710,5294,1416,51,077
01/01/2015 12:00:00 AM,"Covington city, Virginia",2476,1834,642,51,580
01/01/2016 12:00:00 AM,"Greene County, Virginia",7107,5546,1561,51,079
01/01/2016 12:00:00 AM,"Greensville County, Virginia",3705,2815,890,51,081
01/01/2016 12:00:00 AM,"Halifax County, Virginia",14264,10152,4112,51,083
01/01/2016 12:00:00 AM,"Hanover County, Virginia",37724,30630,7094,51,085
01/01/2016 12:00:00 AM,"Henrico County, Virginia",125478,78606,46872,51,087
01/01/2015 12:00:00 AM,"Danville city, Virginia",18559,10013,8546,51,590
01/01/2016 12:00:00 AM,"Henry County, Virginia",22136,16253,5883,51,089
01/01/2015 12:00:00 AM,"Emporia city, Virginia",2459,1050,1409,51,595
01/01/2016 12:00:00 AM,"Highland County, Virginia",1121,957,164,51,091
01/01/2015 12:00:00 AM,"Fairfax city, Virginia",8467,5925,2542,51,600
01/01/2016 12:00:00 AM,"Isle of Wight County, Virginia",13902,10851,3051,51,093
01/01/2015 12:00:00 AM,"Falls Church city, Virginia",5166,3031,2135,51,610
01/01/2016 12:00:00 AM,"James City County, Virginia",28352,21308,7044,51,095
01/01/2015 12:00:00 AM,"Franklin city, Virginia",3453,1648,1805,51,620
01/01/2016 12:00:00 AM,"King and Queen County, Virginia",2807,2214,593,51,097
01/01/2015 12:00:00 AM,"Fredericksburg city, Virginia",10080,3473,6607,51,630
01/01/2016 12:00:00 AM,"King George County, Virginia",8669,6349,2320,51,099
01/01/2015 12:00:00 AM,"Galax city, Virginia",2961,1765,1196,51,640
01/01/2016 12:00:00 AM,"King William County, Virginia",6066,5100,966,51,101
01/01/2015 12:00:00 AM,"Hampton city, Virginia",52940,30486,22454,51,650
01/01/2016 12:00:00 AM,"Lancaster County, Virginia",5097,3822,1275,51,103
01/01/2016 12:00:00 AM,"Lee County, Virginia",9282,6655,2627,51,105
01/01/2015 12:00:00 AM,"Harrisonburg city, Virginia",16409,5926,10483,51,660
01/01/2016 12:00:00 AM,"Loudoun County, Virginia",117073,90656,26417,51,107
01/01/2015 12:00:00 AM,"Hopewell city, Virginia",8706,4470,4236,51,670
01/01/2015 12:00:00 AM,"Lexington city, Virginia",1638,941,697,51,678
01/01/2016 12:00:00 AM,"Louisa County, Virginia",13146,10288,2858,51,109
01/01/2015 12:00:00 AM,"Lynchburg city, Virginia",28528,14458,14070,51,680
01/01/2016 12:00:00 AM,"Lunenburg County, Virginia",4670,3319,1351,51,111
01/01/2016 12:00:00 AM,"Madison County, Virginia",5042,3657,1385,51,113
01/01/2015 12:00:00 AM,"Manassas city, Virginia",12433,7988,4445,51,683
01/01/2016 12:00:00 AM,"Mathews County, Virginia",3837,3246,591,51,115
01/01/2015 12:00:00 AM,"Manassas Park city, Virginia",4723,3246,1477,51,685
01/01/2016 12:00:00 AM,"Mecklenburg County, Virginia",12066,8660,3406,51,117
01/01/2015 12:00:00 AM,"Martinsville city, Virginia",5857,3096,2761,51,690
01/01/2015 12:00:00 AM,"Newport News city, Virginia",69073,34694,34379,51,700
01/01/2016 12:00:00 AM,"Middlesex County, Virginia",4474,3678,796,51,119
01/01/2016 12:00:00 AM,"Montgomery County, Virginia",35701,19130,16571,51,121
01/01/2016 12:00:00 AM,"Nelson County, Virginia",6378,4649,1729,51,125
01/01/2016 12:00:00 AM,"New Kent County, Virginia",7537,6335,1202,51,127
01/01/2016 12:00:00 AM,"Northampton County, Virginia",5075,3412,1663,51,131
01/01/2016 12:00:00 AM,"Northumberland County, Virginia",5776,4990,786,51,133
01/01/2016 12:00:00 AM,"Nottoway County, Virginia",5676,3578,2098,51,135
01/01/2016 12:00:00 AM,"Orange County, Virginia",13245,10331,2914,51,137
01/01/2016 12:00:00 AM,"Page County, Virginia",9523,6712,2811,51,139
01/01/2016 12:00:00 AM,"Patrick County, Virginia",7805,6014,1791,51,141
01/01/2016 12:00:00 AM,"Pittsylvania County, Virginia",26327,20094,6233,51,143
01/01/2016 12:00:00 AM,"Powhatan County, Virginia",9866,8737,1129,51,145
01/01/2016 12:00:00 AM,"Prince Edward County, Virginia",7294,4711,2583,51,147
01/01/2016 12:00:00 AM,"Prince George County, Virginia",11191,7667,3524,51,149
01/01/2015 12:00:00 AM,"Norfolk city, Virginia",87045,37853,49192,51,710
01/01/2015 12:00:00 AM,"Norton city, Virginia",1783,908,875,51,720
01/01/2015 12:00:00 AM,"Petersburg city, Virginia",12803,5301,7502,51,730
01/01/2015 12:00:00 AM,"Poquoson city, Virginia",4642,3811,831,51,735
01/01/2015 12:00:00 AM,"Portsmouth city, Virginia",36757,20129,16628,51,740
01/01/2015 12:00:00 AM,"Radford city, Virginia",5477,2395,3082,51,750
01/01/2015 12:00:00 AM,"Richmond city, Virginia",87224,36875,50349,51,760
01/01/2015 12:00:00 AM,"Roanoke city, Virginia",42239,22688,19551,51,770
01/01/2015 12:00:00 AM,"Salem city, Virginia",10045,6651,3394,51,775
01/01/2015 12:00:00 AM,"Staunton city, Virginia",10387,5900,4487,51,790
01/01/2015 12:00:00 AM,"Suffolk city, Virginia",30990,21882,9108,51,800
01/01/2015 12:00:00 AM,"Virginia Beach city, Virginia",166242,105601,60641,51,810
01/01/2015 12:00:00 AM,"Waynesboro city, Virginia",9031,5215,3816,51,820
01/01/2015 12:00:00 AM,"Williamsburg city, Virginia",4538,2086,2452,51,830
01/01/2015 12:00:00 AM,"Winchester city, Virginia",10608,4758,5850,51,840
01/01/2011 12:00:00 AM,"Dickenson County, Virginia",6183,4835,1348,51,051
01/01/2011 12:00:00 AM,"Dinwiddie County, Virginia",9598,7442,2156,51,053
01/01/2011 12:00:00 AM,"Essex County, Virginia",4420,3379,1041,51,057
01/01/2011 12:00:00 AM,"Fairfax County, Virginia",385570,273783,111787,51,059
01/01/2011 12:00:00 AM,"Fauquier County, Virginia",22888,17983,4905,51,061
01/01/2011 12:00:00 AM,"Floyd County, Virginia",6148,4757,1391,51,063
01/01/2011 12:00:00 AM,"Fluvanna County, Virginia",9315,8109,1206,51,065
01/01/2011 12:00:00 AM,"Franklin County, Virginia",23581,18695,4886,51,067
01/01/2011 12:00:00 AM,"Frederick County, Virginia",28655,22508,6147,51,069
01/01/2011 12:00:00 AM,"Giles County, Virginia",7054,5494,1560,51,071
01/01/2011 12:00:00 AM,"Gloucester County, Virginia",13892,11680,2212,51,073
01/01/2011 12:00:00 AM,"Goochland County, Virginia",7822,7257,565,51,075
01/01/2011 12:00:00 AM,"Grayson County, Virginia",6760,5412,1348,51,077
01/01/2011 12:00:00 AM,"Greene County, Virginia",6802,5439,1363,51,079
01/01/2011 12:00:00 AM,"Greensville County, Virginia",3264,2360,904,51,081
01/01/2011 12:00:00 AM,"Halifax County, Virginia",14533,11072,3461,51,083
01/01/2011 12:00:00 AM,"Hanover County, Virginia",36489,30595,5894,51,085
01/01/2011 12:00:00 AM,"Henrico County, Virginia",122919,81438,41481,51,087
01/01/2011 12:00:00 AM,"Henry County, Virginia",22871,17041,5830,51,089
01/01/2011 12:00:00 AM,"Highland County, Virginia",1110,890,220,51,091
01/01/2011 12:00:00 AM,"Isle of Wight County, Virginia",13528,10988,2540,51,093
01/01/2011 12:00:00 AM,"James City County, Virginia",26356,20000,6356,51,095
01/01/2011 12:00:00 AM,"King and Queen County, Virginia",2891,2325,566,51,097
01/01/2011 12:00:00 AM,"King George County, Virginia",8200,6133,2067,51,099
01/01/2011 12:00:00 AM,"King William County, Virginia",5985,4981,1004,51,101
01/01/2011 12:00:00 AM,"Lancaster County, Virginia",5570,4298,1272,51,103
01/01/2011 12:00:00 AM,"Lee County, Virginia",10001,7500,2501,51,105
01/01/2011 12:00:00 AM,"Loudoun County, Virginia",99761,78987,20774,51,107
01/01/2011 12:00:00 AM,"Louisa County, Virginia",13213,10299,2914,51,109
01/01/2011 12:00:00 AM,"Lunenburg County, Virginia",4471,3267,1204,51,111
01/01/2011 12:00:00 AM,"Madison County, Virginia",5185,4110,1075,51,113
01/01/2011 12:00:00 AM,"Mathews County, Virginia",3788,3146,642,51,115
01/01/2011 12:00:00 AM,"Mecklenburg County, Virginia",12547,9346,3201,51,117
01/01/2011 12:00:00 AM,"Middlesex County, Virginia",4339,3539,800,51,119
01/01/2011 12:00:00 AM,"Montgomery County, Virginia",34591,19042,15549,51,121
01/01/2011 12:00:00 AM,"Nelson County, Virginia",6539,4907,1632,51,125
01/01/2011 12:00:00 AM,"New Kent County, Virginia",6552,5953,599,51,127
01/01/2011 12:00:00 AM,"Northampton County, Virginia",5195,3607,1588,51,131
01/01/2011 12:00:00 AM,"Northumberland County, Virginia",5569,4626,943,51,133
01/01/2011 12:00:00 AM,"Nottoway County, Virginia",5571,3771,1800,51,135
01/01/2011 12:00:00 AM,"Orange County, Virginia",12614,9622,2992,51,137
01/01/2011 12:00:00 AM,"Page County, Virginia",9538,7183,2355,51,139
01/01/2011 12:00:00 AM,"Patrick County, Virginia",7191,5738,1453,51,141
01/01/2011 12:00:00 AM,"Pittsylvania County, Virginia",26325,20960,5365,51,143
01/01/2011 12:00:00 AM,"Powhatan County, Virginia",9468,8406,1062,51,145
01/01/2011 12:00:00 AM,"Prince Edward County, Virginia",7334,4817,2517,51,147
01/01/2011 12:00:00 AM,"Prince George County, Virginia",10725,8141,2584,51,149
01/01/2011 12:00:00 AM,"Prince William County, Virginia",127170,94336,32834,51,153
01/01/2011 12:00:00 AM,"Pulaski County, Virginia",14884,10798,4086,51,155
01/01/2011 12:00:00 AM,"Rappahannock County, Virginia",3310,2486,824,51,157
01/01/2011 12:00:00 AM,"Richmond County, Virginia",2909,2297,612,51,159
01/01/2011 12:00:00 AM,"Roanoke County, Virginia",37975,29266,8709,51,161
01/01/2011 12:00:00 AM,"Rockbridge County, Virginia",9291,6833,2458,51,163
01/01/2011 12:00:00 AM,"Rockingham County, Virginia",29711,22697,7014,51,165
01/01/2011 12:00:00 AM,"Russell County, Virginia",11302,8666,2636,51,167
01/01/2011 12:00:00 AM,"Scott County, Virginia",9701,7571,2130,51,169
01/01/2011 12:00:00 AM,"Shenandoah County, Virginia",17152,12062,5090,51,171
01/01/2011 12:00:00 AM,"Smyth County, Virginia",12681,9055,3626,51,173
01/01/2011 12:00:00 AM,"Southampton County, Virginia",6618,4884,1734,51,175
01/01/2011 12:00:00 AM,"Spotsylvania County, Virginia",41282,32204,9078,51,177
01/01/2011 12:00:00 AM,"Stafford County, Virginia",40691,32086,8605,51,179
01/01/2011 12:00:00 AM,"Surry County, Virginia",2547,1888,659,51,181
01/01/2011 12:00:00 AM,"Sussex County, Virginia",3600,2315,1285,51,183
01/01/2011 12:00:00 AM,"Tazewell County, Virginia",18019,13105,4914,51,185
01/01/2011 12:00:00 AM,"Warren County, Virginia",14203,10554,3649,51,187
01/01/2011 12:00:00 AM,"Washington County, Virginia",23064,17279,5785,51,191
01/01/2011 12:00:00 AM,"Westmoreland County, Virginia",7077,5309,1768,51,193
01/01/2011 12:00:00 AM,"Wise County, Virginia",15477,10839,4638,51,195
01/01/2011 12:00:00 AM,"Wythe County, Virginia",11610,8563,3047,51,197
01/01/2011 12:00:00 AM,"York County, Virginia",24259,18735,5524,51,199
01/01/2011 12:00:00 AM,"Alexandria city, Virginia",64217,28868,35349,51,510
01/01/2011 12:00:00 AM,"Bedford city, Virginia",2776,1735,1041,51,515
01/01/2011 12:00:00 AM,"Bristol city, Virginia",7873,4769,3104,51,520
01/01/2011 12:00:00 AM,"Buena Vista city, Virginia",2681,1712,969,51,530
01/01/2011 12:00:00 AM,"Charlottesville city, Virginia",17387,7179,10208,51,540
01/01/2011 12:00:00 AM,"Chesapeake city, Virginia",78898,58660,20238,51,550
01/01/2011 12:00:00 AM,"Colonial Heights city, Virginia",7136,4659,2477,51,570
01/01/2011 12:00:00 AM,"Covington city, Virginia",2546,1790,756,51,580
01/01/2011 12:00:00 AM,"Danville city, Virginia",18938,10426,8512,51,590
01/01/2011 12:00:00 AM,"Emporia city, Virginia",2525,1216,1309,51,595
01/01/2011 12:00:00 AM,"Fairfax city, Virginia",8470,5880,2590,51,600
01/01/2011 12:00:00 AM,"Falls Church city, Virginia",4807,2966,1841,51,610
01/01/2011 12:00:00 AM,"Franklin city, Virginia",3472,1475,1997,51,620
01/01/2011 12:00:00 AM,"Fredericksburg city, Virginia",9341,3619,5722,51,630
01/01/2011 12:00:00 AM,"Galax city, Virginia",3525,2227,1298,51,640
01/01/2011 12:00:00 AM,"Hampton city, Virginia",52667,32165,20502,51,650
01/01/2011 12:00:00 AM,"Harrisonburg city, Virginia",15179,5667,9512,51,660
01/01/2011 12:00:00 AM,"Hopewell city, Virginia",8859,4441,4418,51,670
01/01/2011 12:00:00 AM,"Lexington city, Virginia",1727,880,847,51,678
01/01/2011 12:00:00 AM,"Lynchburg city, Virginia",28513,15796,12717,51,680
01/01/2011 12:00:00 AM,"Manassas city, Virginia",11872,7883,3989,51,683
01/01/2011 12:00:00 AM,"Manassas Park city, Virginia",4238,2867,1371,51,685
01/01/2011 12:00:00 AM,"Martinsville city, Virginia",5958,3444,2514,51,690
01/01/2011 12:00:00 AM,"Newport News city, Virginia",69977,36279,33698,51,700
01/01/2011 12:00:00 AM,"Norfolk city, Virginia",85076,39469,45607,51,710
01/01/2011 12:00:00 AM,"Norton city, Virginia",1750,959,791,51,720
01/01/2011 12:00:00 AM,"Petersburg city, Virginia",12179,5832,6347,51,730
01/01/2011 12:00:00 AM,"Poquoson city, Virginia",4525,3785,740,51,735
01/01/2011 12:00:00 AM,"Portsmouth city, Virginia",36899,22507,14392,51,740
01/01/2011 12:00:00 AM,"Radford city, Virginia",5644,2744,2900,51,750
01/01/2011 12:00:00 AM,"Richmond city, Virginia",83615,37574,46041,51,760
01/01/2011 12:00:00 AM,"Roanoke city, Virginia",42892,24212,18680,51,770
01/01/2011 12:00:00 AM,"Salem city, Virginia",9944,6859,3085,51,775
01/01/2011 12:00:00 AM,"Staunton city, Virginia",10517,6374,4143,51,790
01/01/2011 12:00:00 AM,"Suffolk city, Virginia",30305,22769,7536,51,800
01/01/2011 12:00:00 AM,"Virginia Beach city, Virginia",164041,108165,55876,51,810
01/01/2011 12:00:00 AM,"Waynesboro city, Virginia",8750,5129,3621,51,820
01/01/2011 12:00:00 AM,"Williamsburg city, Virginia",4206,1830,2376,51,830
01/01/2011 12:00:00 AM,"Winchester city, Virginia",10147,5054,5093,51,840
01/01/2011 12:00:00 AM,"Accomack County, Virginia",13757,10199,3558,51,001
01/01/2011 12:00:00 AM,"Albemarle County, Virginia",37398,24731,12667,51,003
01/01/2011 12:00:00 AM,"Alleghany County, Virginia",6935,5629,1306,51,005
01/01/2011 12:00:00 AM,"Amelia County, Virginia",5001,4049,952,51,007
01/01/2011 12:00:00 AM,"Amherst County, Virginia",12693,9634,3059,51,009
01/01/2011 12:00:00 AM,"Appomattox County, Virginia",5857,4417,1440,51,011
01/01/2011 12:00:00 AM,"Arlington County, Virginia",92436,43096,49340,51,013
01/01/2011 12:00:00 AM,"Augusta County, Virginia",28021,22814,5207,51,015
01/01/2011 12:00:00 AM,"Bath County, Virginia",1926,1633,293,51,017
01/01/2011 12:00:00 AM,"Bedford County, Virginia",26979,22704,4275,51,019
01/01/2011 12:00:00 AM,"Bland County, Virginia",2663,2234,429,51,021
01/01/2011 12:00:00 AM,"Botetourt County, Virginia",12789,11230,1559,51,023
01/01/2011 12:00:00 AM,"Brunswick County, Virginia",6126,4314,1812,51,025
01/01/2011 12:00:00 AM,"Buchanan County, Virginia",9135,7192,1943,51,027
01/01/2011 12:00:00 AM,"Buckingham County, Virginia",5699,4175,1524,51,029
01/01/2011 12:00:00 AM,"Campbell County, Virginia",21610,16322,5288,51,031
01/01/2011 12:00:00 AM,"Caroline County, Virginia",10476,8664,1812,51,033
01/01/2011 12:00:00 AM,"Carroll County, Virginia",12556,9737,2819,51,035
01/01/2011 12:00:00 AM,"Charles City County, Virginia",2747,2339,408,51,036
01/01/2011 12:00:00 AM,"Charlotte County, Virginia",4534,3513,1021,51,037
01/01/2011 12:00:00 AM,"Chesterfield County, Virginia",112895,88141,24754,51,041
01/01/2011 12:00:00 AM,"Clarke County, Virginia",5564,4269,1295,51,043
01/01/2011 12:00:00 AM,"Craig County, Virginia",1976,1756,220,51,045
01/01/2011 12:00:00 AM,"Culpeper County, Virginia",15750,11476,4274,51,047
01/01/2011 12:00:00 AM,"Cumberland County, Virginia",3976,3023,953,51,049
01/01/2018 12:00:00 AM,"Tazewell County, Virginia",17042,12923,4119,51,185
01/01/2018 12:00:00 AM,"Falls Church city, Virginia",5262,3243,2019,51,610
01/01/2018 12:00:00 AM,"Manassas Park city, Virginia",4706,3098,1608,51,685
01/01/2018 12:00:00 AM,"Poquoson city, Virginia",4615,3849,766,51,735
01/01/2018 12:00:00 AM,"Sussex County, Virginia",3814,2564,1250,51,183
01/01/2018 12:00:00 AM,"Waynesboro city, Virginia",9144,5359,3785,51,820
01/01/2018 12:00:00 AM,"Roanoke city, Virginia",42037,21783,20254,51,770
01/01/2018 12:00:00 AM,"Salem city, Virginia",9881,6415,3466,51,775
01/01/2018 12:00:00 AM,"Norfolk city, Virginia",88155,38029,50126,51,710
01/01/2018 12:00:00 AM,"Charlotte County, Virginia",4543,3156,1387,51,037
01/01/2018 12:00:00 AM,"Fairfax County, Virginia",394447,268346,126101,51,059
01/01/2018 12:00:00 AM,"Greensville County, Virginia",3688,2698,990,51,081
01/01/2018 12:00:00 AM,"James City County, Virginia",28766,21434,7332,51,095
01/01/2018 12:00:00 AM,"Russell County, Virginia",10965,8343,2622,51,167
01/01/2018 12:00:00 AM,"Smyth County, Virginia",12881,9193,3688,51,173
01/01/2018 12:00:00 AM,"Lexington city, Virginia",1984,1050,934,51,678
01/01/2018 12:00:00 AM,"Campbell County, Virginia",22957,17271,5686,51,031
01/01/2018 12:00:00 AM,"Henry County, Virginia",21598,15629,5969,51,089
01/01/2018 12:00:00 AM,"King George County, Virginia",9103,7014,2089,51,099
01/01/2018 12:00:00 AM,"Lancaster County, Virginia",5142,3890,1252,51,103
01/01/2018 12:00:00 AM,"Lee County, Virginia",9149,6465,2684,51,105
01/01/2018 12:00:00 AM,"Mathews County, Virginia",3908,3406,502,51,115
01/01/2018 12:00:00 AM,"Middlesex County, Virginia",4454,3585,869,51,119
01/01/2018 12:00:00 AM,"Prince George County, Virginia",11415,7648,3767,51,149
01/01/2018 12:00:00 AM,"Rockingham County, Virginia",30946,22832,8114,51,165
01/01/2018 12:00:00 AM,"Scott County, Virginia",8767,6833,1934,51,169
01/01/2018 12:00:00 AM,"Surry County, Virginia",2760,2121,639,51,181
01/01/2018 12:00:00 AM,"Appomattox County, Virginia",6095,4733,1362,51,011
01/01/2018 12:00:00 AM,"Franklin County, Virginia",23104,18447,4657,51,067
01/01/2018 12:00:00 AM,"King and Queen County, Virginia",2826,2362,464,51,097
01/01/2018 12:00:00 AM,"Montgomery County, Virginia",35483,19530,15953,51,121
01/01/2018 12:00:00 AM,"New Kent County, Virginia",7754,6606,1148,51,127
01/01/2018 12:00:00 AM,"Cumberland County, Virginia",3963,2892,1071,51,049
01/01/2018 12:00:00 AM,"Goochland County, Virginia",8426,7157,1269,51,075
01/01/2018 12:00:00 AM,"Halifax County, Virginia",14025,10476,3549,51,083
01/01/2018 12:00:00 AM,"Madison County, Virginia",5078,3714,1364,51,113
01/01/2018 12:00:00 AM,"Prince William County, Virginia",140473,102811,37662,51,153
01/01/2018 12:00:00 AM,"Southampton County, Virginia",6522,4771,1751,51,175
01/01/2018 12:00:00 AM,"Highland County, Virginia",1123,920,203,51,091
01/01/2018 12:00:00 AM,"Brunswick County, Virginia",6048,4336,1712,51,025
01/01/2018 12:00:00 AM,"Caroline County, Virginia",10911,8868,2043,51,033
01/01/2018 12:00:00 AM,"Gloucester County, Virginia",14759,11261,3498,51,073
01/01/2018 12:00:00 AM,"Northampton County, Virginia",5151,3371,1780,51,131
01/01/2018 12:00:00 AM,"Patrick County, Virginia",7685,5878,1807,51,141
01/01/2018 12:00:00 AM,"Powhatan County, Virginia",10178,9119,1059,51,145
01/01/2018 12:00:00 AM,"Rockbridge County, Virginia",8979,7033,1946,51,163
01/01/2018 12:00:00 AM,"Shenandoah County, Virginia",17315,12229,5086,51,171
01/01/2018 12:00:00 AM,"Fauquier County, Virginia",24333,19017,5316,51,061
01/01/2018 12:00:00 AM,"Charles City County, Virginia",2856,2387,469,51,036
01/01/2018 12:00:00 AM,"Culpeper County, Virginia",16903,12539,4364,51,047
01/01/2018 12:00:00 AM,"Dinwiddie County, Virginia",10391,7900,2491,51,053
01/01/2018 12:00:00 AM,"Greene County, Virginia",7357,5898,1459,51,079
01/01/2018 12:00:00 AM,"Hanover County, Virginia",38599,31513,7086,51,085
01/01/2018 12:00:00 AM,"Lunenburg County, Virginia",4331,3088,1243,51,111
01/01/2018 12:00:00 AM,"Orange County, Virginia",13453,10448,3005,51,137
01/01/2018 12:00:00 AM,"Harrisonburg city, Virginia",16768,6398,10370,51,660
01/01/2018 12:00:00 AM,"Emporia city, Virginia",2119,879,1240,51,595
01/01/2018 12:00:00 AM,"Wythe County, Virginia",11955,9112,2843,51,197
01/01/2018 12:00:00 AM,"Chesapeake city, Virginia",84230,60083,24147,51,550
01/01/2018 12:00:00 AM,"Albemarle County, Virginia",40612,25391,15221,51,003
01/01/2018 12:00:00 AM,"Bedford County, Virginia",31206,25472,5734,51,019
01/01/2018 12:00:00 AM,"Botetourt County, Virginia",13161,11353,1808,51,023
01/01/2018 12:00:00 AM,"Wise County, Virginia",15126,9980,5146,51,195
01/01/2018 12:00:00 AM,"Bristol city, Virginia",7402,4362,3040,51,520
01/01/2018 12:00:00 AM,"Portsmouth city, Virginia",36471,19810,16661,51,740
01/01/2018 12:00:00 AM,"Williamsburg city, Virginia",4670,2301,2369,51,830
01/01/2018 12:00:00 AM,"Alleghany County, Virginia",6741,5237,1504,51,005
01/01/2018 12:00:00 AM,"Carroll County, Virginia",12375,9526,2849,51,035
01/01/2018 12:00:00 AM,"Washington County, Virginia",22331,16799,5532,51,191
01/01/2018 12:00:00 AM,"Northumberland County, Virginia",5686,4852,834,51,133
01/01/2018 12:00:00 AM,"Page County, Virginia",9338,6546,2792,51,139
01/01/2018 12:00:00 AM,"Warren County, Virginia",14379,11072,3307,51,187
01/01/2018 12:00:00 AM,"Alexandria city, Virginia",69979,29989,39990,51,510
01/01/2018 12:00:00 AM,"Fredericksburg city, Virginia",10582,3829,6753,51,630
01/01/2018 12:00:00 AM,"Hampton city, Virginia",53700,30167,23533,51,650
01/01/2018 12:00:00 AM,"Arlington County, Virginia",104716,45504,59212,51,013
01/01/2018 12:00:00 AM,"Hopewell city, Virginia",9193,4572,4621,51,670
01/01/2018 12:00:00 AM,"Buchanan County, Virginia",8871,6925,1946,51,027
01/01/2018 12:00:00 AM,"Frederick County, Virginia",30973,24065,6908,51,069
01/01/2018 12:00:00 AM,"Stafford County, Virginia",46328,35289,11039,51,179
01/01/2018 12:00:00 AM,"York County, Virginia",24617,17676,6941,51,199
01/01/2018 12:00:00 AM,"Richmond city, Virginia",89846,37956,51890,51,760
01/01/2018 12:00:00 AM,"Nelson County, Virginia",6445,4787,1658,51,125
01/01/2018 12:00:00 AM,"Pittsylvania County, Virginia",26330,19750,6580,51,143
01/01/2018 12:00:00 AM,"Norton city, Virginia",1819,843,976,51,720
01/01/2018 12:00:00 AM,"Fluvanna County, Virginia",9842,8256,1586,51,065
01/01/2018 12:00:00 AM,"Amelia County, Virginia",4789,4036,753,51,007
01/01/2018 12:00:00 AM,"Winchester city, Virginia",10554,4950,5604,51,840
01/01/2018 12:00:00 AM,"Accomack County, Virginia",13401,9093,4308,51,001
01/01/2018 12:00:00 AM,"Floyd County, Virginia",6480,5326,1154,51,063
01/01/2018 12:00:00 AM,"Grayson County, Virginia",6542,5184,1358,51,077
01/01/2018 12:00:00 AM,"Nottoway County, Virginia",5542,3396,2146,51,135
01/01/2018 12:00:00 AM,"Buena Vista city, Virginia",2539,1694,845,51,530
01/01/2018 12:00:00 AM,"Petersburg city, Virginia",13274,5376,7898,51,730
01/01/2018 12:00:00 AM,"Fairfax city, Virginia",8553,6066,2487,51,600
01/01/2018 12:00:00 AM,"Manassas city, Virginia",12749,8301,4448,51,683
01/01/2018 12:00:00 AM,"Suffolk city, Virginia",33198,23001,10197,51,800
01/01/2018 12:00:00 AM,"Chesterfield County, Virginia",123010,92822,30188,51,041
01/01/2018 12:00:00 AM,"Isle of Wight County, Virginia",14304,10692,3612,51,093
01/01/2018 12:00:00 AM,"Franklin city, Virginia",3526,1755,1771,51,620
01/01/2018 12:00:00 AM,"Charlottesville city, Virginia",18613,8045,10568,51,540
01/01/2018 12:00:00 AM,"Henrico County, Virginia",127111,79703,47408,51,087
01/01/2018 12:00:00 AM,"King William County, Virginia",6170,5321,849,51,101
01/01/2018 12:00:00 AM,"Louisa County, Virginia",13575,10818,2757,51,109
01/01/2018 12:00:00 AM,"Prince Edward County, Virginia",7187,4808,2379,51,147
01/01/2018 12:00:00 AM,"Richmond County, Virginia",3139,2262,877,51,159
01/01/2018 12:00:00 AM,"Spotsylvania County, Virginia",43677,33923,9754,51,177
01/01/2018 12:00:00 AM,"Clarke County, Virginia",5639,4216,1423,51,043
01/01/2018 12:00:00 AM,"Mecklenburg County, Virginia",11815,8257,3558,51,117
01/01/2018 12:00:00 AM,"Augusta County, Virginia",29297,23110,6187,51,015
01/01/2018 12:00:00 AM,"Dickenson County, Virginia",5841,4456,1385,51,051
01/01/2018 12:00:00 AM,"Loudoun County, Virginia",125309,97513,27796,51,107
01/01/2018 12:00:00 AM,"Roanoke County, Virginia",38343,28403,9940,51,161
01/01/2018 12:00:00 AM,"Colonial Heights city, Virginia",7054,4484,2570,51,570
01/01/2018 12:00:00 AM,"Bland County, Virginia",2523,2087,436,51,021
01/01/2018 12:00:00 AM,"Buckingham County, Virginia",5827,4385,1442,51,029
01/01/2018 12:00:00 AM,"Covington city, Virginia",2409,1771,638,51,580
01/01/2018 12:00:00 AM,"Virginia Beach city, Virginia",169290,108486,60804,51,810
01/01/2018 12:00:00 AM,"Galax city, Virginia",2742,1799,943,51,640
01/01/2018 12:00:00 AM,"Westmoreland County, Virginia",7612,5669,1943,51,193
01/01/2018 12:00:00 AM,"Pulaski County, Virginia",14525,10507,4018,51,155
01/01/2018 12:00:00 AM,"Danville city, Virginia",18479,9878,8601,51,590
01/01/2018 12:00:00 AM,"Amherst County, Virginia",12044,9349,2695,51,009
01/01/2018 12:00:00 AM,"Bath County, Virginia",1999,1443,556,51,017
01/01/2018 12:00:00 AM,"Newport News city, Virginia",69324,34043,35281,51,700
01/01/2018 12:00:00 AM,"Lynchburg city, Virginia",28069,13953,14116,51,680
01/01/2018 12:00:00 AM,"Martinsville city, Virginia",5630,3283,2347,51,690
01/01/2018 12:00:00 AM,"Essex County, Virginia",4463,3108,1355,51,057
01/01/2018 12:00:00 AM,"Staunton city, Virginia",10520,5974,4546,51,790
01/01/2018 12:00:00 AM,"Radford city, Virginia",5438,2676,2762,51,750
01/01/2018 12:00:00 AM,"Craig County, Virginia",2266,1636,630,51,045
01/01/2018 12:00:00 AM,"Giles County, Virginia",6987,5363,1624,51,071
01/01/2018 12:00:00 AM,"Rappahannock County, Virginia",2976,2196,780,51,157
01/01/2012 12:00:00 AM,"Accomack County, Virginia",14286,10070,4216,51,001
01/01/2012 12:00:00 AM,"Albemarle County, Virginia",37549,24648,12901,51,003
01/01/2012 12:00:00 AM,"Alleghany County, Virginia",6851,5617,1234,51,005
01/01/2012 12:00:00 AM,"Amelia County, Virginia",4777,3867,910,51,007
01/01/2012 12:00:00 AM,"Amherst County, Virginia",12683,9614,3069,51,009
01/01/2012 12:00:00 AM,"Appomattox County, Virginia",5902,4512,1390,51,011
01/01/2012 12:00:00 AM,"Arlington County, Virginia",92992,42696,50296,51,013
01/01/2012 12:00:00 AM,"Augusta County, Virginia",28297,23005,5292,51,015
01/01/2012 12:00:00 AM,"Bath County, Virginia",2008,1606,402,51,017
01/01/2012 12:00:00 AM,"Bedford County, Virginia",27017,22899,4118,51,019
01/01/2012 12:00:00 AM,"Bland County, Virginia",2464,2031,433,51,021
01/01/2012 12:00:00 AM,"Botetourt County, Virginia",12822,11217,1605,51,023
01/01/2012 12:00:00 AM,"Brunswick County, Virginia",6029,4257,1772,51,025
01/01/2012 12:00:00 AM,"Buchanan County, Virginia",9384,7339,2045,51,027
01/01/2012 12:00:00 AM,"Buckingham County, Virginia",5728,4301,1427,51,029
01/01/2012 12:00:00 AM,"Campbell County, Virginia",21581,16504,5077,51,031
01/01/2012 12:00:00 AM,"Caroline County, Virginia",10649,8830,1819,51,033
01/01/2012 12:00:00 AM,"Carroll County, Virginia",12622,9872,2750,51,035
01/01/2012 12:00:00 AM,"Charles City County, Virginia",2777,2279,498,51,036
01/01/2012 12:00:00 AM,"Charlotte County, Virginia",4803,3621,1182,51,037
01/01/2012 12:00:00 AM,"Chesterfield County, Virginia",113090,88028,25062,51,041
01/01/2012 12:00:00 AM,"Clarke County, Virginia",5580,4387,1193,51,043
01/01/2012 12:00:00 AM,"Craig County, Virginia",2073,1772,301,51,045
01/01/2012 12:00:00 AM,"Culpeper County, Virginia",15826,11654,4172,51,047
01/01/2012 12:00:00 AM,"Cumberland County, Virginia",4016,3103,913,51,049
01/01/2012 12:00:00 AM,"Dickenson County, Virginia",6404,5034,1370,51,051
01/01/2012 12:00:00 AM,"Dinwiddie County, Virginia",9788,7409,2379,51,053
01/01/2012 12:00:00 AM,"Essex County, Virginia",4351,3309,1042,51,057
01/01/2012 12:00:00 AM,"Fairfax County, Virginia",388452,270928,117524,51,059
01/01/2012 12:00:00 AM,"Fauquier County, Virginia",23031,18216,4815,51,061
01/01/2012 12:00:00 AM,"Floyd County, Virginia",6076,4725,1351,51,063
01/01/2012 12:00:00 AM,"Fluvanna County, Virginia",9419,8254,1165,51,065
01/01/2012 12:00:00 AM,"Franklin County, Virginia",23552,18310,5242,51,067
01/01/2012 12:00:00 AM,"Frederick County, Virginia",29146,23162,5984,51,069
01/01/2012 12:00:00 AM,"Giles County, Virginia",7126,5516,1610,51,071
01/01/2012 12:00:00 AM,"Gloucester County, Virginia",13874,11639,2235,51,073
01/01/2012 12:00:00 AM,"Goochland County, Virginia",7909,7247,662,51,075
01/01/2012 12:00:00 AM,"Grayson County, Virginia",6807,5282,1525,51,077
01/01/2012 12:00:00 AM,"Greene County, Virginia",6884,5347,1537,51,079
01/01/2012 12:00:00 AM,"Greensville County, Virginia",3310,2327,983,51,081
01/01/2012 12:00:00 AM,"Halifax County, Virginia",14685,10856,3829,51,083
01/01/2012 12:00:00 AM,"Hanover County, Virginia",36444,30543,5901,51,085
01/01/2012 12:00:00 AM,"Henrico County, Virginia",123392,81193,42199,51,087
01/01/2012 12:00:00 AM,"Henry County, Virginia",22734,17218,5516,51,089
01/01/2012 12:00:00 AM,"Highland County, Virginia",1052,881,171,51,091
01/01/2012 12:00:00 AM,"Isle of Wight County, Virginia",13585,10929,2656,51,093
01/01/2012 12:00:00 AM,"James City County, Virginia",26579,20306,6273,51,095
01/01/2012 12:00:00 AM,"King and Queen County, Virginia",2924,2261,663,51,097
01/01/2012 12:00:00 AM,"King George County, Virginia",8166,6132,2034,51,099
01/01/2012 12:00:00 AM,"King William County, Virginia",6035,5021,1014,51,101
01/01/2012 12:00:00 AM,"Lancaster County, Virginia",5395,4309,1086,51,103
01/01/2012 12:00:00 AM,"Lee County, Virginia",9841,7385,2456,51,105
01/01/2012 12:00:00 AM,"Loudoun County, Virginia",104195,81476,22719,51,107
01/01/2012 12:00:00 AM,"Louisa County, Virginia",13023,10471,2552,51,109
01/01/2012 12:00:00 AM,"Lunenburg County, Virginia",4601,3446,1155,51,111
01/01/2012 12:00:00 AM,"Madison County, Virginia",5069,4014,1055,51,113
01/01/2012 12:00:00 AM,"Mathews County, Virginia",3815,3029,786,51,115
01/01/2012 12:00:00 AM,"Mecklenburg County, Virginia",12642,9204,3438,51,117
01/01/2012 12:00:00 AM,"Middlesex County, Virginia",4393,3653,740,51,119
01/01/2012 12:00:00 AM,"Montgomery County, Virginia",34739,18851,15888,51,121
01/01/2012 12:00:00 AM,"Nelson County, Virginia",6415,4951,1464,51,125
01/01/2012 12:00:00 AM,"New Kent County, Virginia",6719,6019,700,51,127
01/01/2012 12:00:00 AM,"Northampton County, Virginia",5025,3487,1538,51,131
01/01/2012 12:00:00 AM,"Northumberland County, Virginia",5557,4712,845,51,133
01/01/2012 12:00:00 AM,"Nottoway County, Virginia",5504,3741,1763,51,135
01/01/2012 12:00:00 AM,"Orange County, Virginia",12617,9778,2839,51,137
01/01/2012 12:00:00 AM,"Page County, Virginia",9469,7076,2393,51,139
01/01/2012 12:00:00 AM,"Patrick County, Virginia",7519,5873,1646,51,141
01/01/2012 12:00:00 AM,"Pittsylvania County, Virginia",26249,21011,5238,51,143
01/01/2012 12:00:00 AM,"Powhatan County, Virginia",9429,8380,1049,51,145
01/01/2012 12:00:00 AM,"Prince Edward County, Virginia",7227,4979,2248,51,147
01/01/2012 12:00:00 AM,"Prince George County, Virginia",10811,8058,2753,51,149
01/01/2012 12:00:00 AM,"Prince William County, Virginia",129643,94406,35237,51,153
01/01/2012 12:00:00 AM,"Pulaski County, Virginia",14874,10668,4206,51,155
01/01/2012 12:00:00 AM,"Rappahannock County, Virginia",3276,2536,740,51,157
01/01/2012 12:00:00 AM,"Richmond County, Virginia",2754,2006,748,51,159
01/01/2012 12:00:00 AM,"Roanoke County, Virginia",37876,28865,9011,51,161
01/01/2012 12:00:00 AM,"Rockbridge County, Virginia",9093,6622,2471,51,163
01/01/2012 12:00:00 AM,"Rockingham County, Virginia",29616,22730,6886,51,165
01/01/2012 12:00:00 AM,"Russell County, Virginia",11140,8590,2550,51,167
01/01/2012 12:00:00 AM,"Scott County, Virginia",9610,7516,2094,51,169
01/01/2012 12:00:00 AM,"Shenandoah County, Virginia",17261,12252,5009,51,171
01/01/2012 12:00:00 AM,"Smyth County, Virginia",12567,8899,3668,51,173
01/01/2012 12:00:00 AM,"Southampton County, Virginia",6532,4770,1762,51,175
01/01/2012 12:00:00 AM,"Spotsylvania County, Virginia",41380,32285,9095,51,177
01/01/2012 12:00:00 AM,"Stafford County, Virginia",41204,32278,8926,51,179
01/01/2012 12:00:00 AM,"Surry County, Virginia",2572,1991,581,51,181
01/01/2012 12:00:00 AM,"Sussex County, Virginia",3639,2387,1252,51,183
01/01/2012 12:00:00 AM,"Tazewell County, Virginia",18136,13098,5038,51,185
01/01/2012 12:00:00 AM,"Warren County, Virginia",14349,10272,4077,51,187
01/01/2012 12:00:00 AM,"Washington County, Virginia",22913,17266,5647,51,191
01/01/2012 12:00:00 AM,"Westmoreland County, Virginia",7077,5409,1668,51,193
01/01/2012 12:00:00 AM,"Wise County, Virginia",15673,10873,4800,51,195
01/01/2012 12:00:00 AM,"Wythe County, Virginia",11610,8381,3229,51,197
01/01/2012 12:00:00 AM,"York County, Virginia",24008,18199,5809,51,199
01/01/2012 12:00:00 AM,"Alexandria city, Virginia",64729,28403,36326,51,510
01/01/2012 12:00:00 AM,"Bedford city, Virginia",2723,1653,1070,51,515
01/01/2012 12:00:00 AM,"Bristol city, Virginia",7757,4546,3211,51,520
01/01/2012 12:00:00 AM,"Buena Vista city, Virginia",2732,1819,913,51,530
01/01/2012 12:00:00 AM,"Charlottesville city, Virginia",17319,7061,10258,51,540
01/01/2012 12:00:00 AM,"Chesapeake city, Virginia",79380,57875,21505,51,550
01/01/2012 12:00:00 AM,"Colonial Heights city, Virginia",7004,4612,2392,51,570
01/01/2012 12:00:00 AM,"Covington city, Virginia",2584,1774,810,51,580
01/01/2012 12:00:00 AM,"Danville city, Virginia",18986,10295,8691,51,590
01/01/2012 12:00:00 AM,"Emporia city, Virginia",2486,1100,1386,51,595
01/01/2012 12:00:00 AM,"Fairfax city, Virginia",8519,5958,2561,51,600
01/01/2012 12:00:00 AM,"Falls Church city, Virginia",4857,3024,1833,51,610
01/01/2012 12:00:00 AM,"Franklin city, Virginia",3532,1515,2017,51,620
01/01/2012 12:00:00 AM,"Fredericksburg city, Virginia",9705,3650,6055,51,630
01/01/2012 12:00:00 AM,"Galax city, Virginia",3354,2168,1186,51,640
01/01/2012 12:00:00 AM,"Hampton city, Virginia",52547,31664,20883,51,650
01/01/2012 12:00:00 AM,"Harrisonburg city, Virginia",15334,5587,9747,51,660
01/01/2012 12:00:00 AM,"Hopewell city, Virginia",8686,4420,4266,51,670
01/01/2012 12:00:00 AM,"Lexington city, Virginia",1801,980,821,51,678
01/01/2012 12:00:00 AM,"Lynchburg city, Virginia",28466,15488,12978,51,680
01/01/2012 12:00:00 AM,"Manassas city, Virginia",12011,7842,4169,51,683
01/01/2012 12:00:00 AM,"Manassas Park city, Virginia",4277,2816,1461,51,685
01/01/2012 12:00:00 AM,"Martinsville city, Virginia",6005,3326,2679,51,690
01/01/2012 12:00:00 AM,"Newport News city, Virginia",69467,35748,33719,51,700
01/01/2012 12:00:00 AM,"Norfolk city, Virginia",85247,38889,46358,51,710
01/01/2012 12:00:00 AM,"Norton city, Virginia",1701,888,813,51,720
01/01/2012 12:00:00 AM,"Petersburg city, Virginia",12236,5715,6521,51,730
01/01/2012 12:00:00 AM,"Poquoson city, Virginia",4592,3888,704,51,735
01/01/2012 12:00:00 AM,"Portsmouth city, Virginia",36788,21687,15101,51,740
01/01/2012 12:00:00 AM,"Radford city, Virginia",5624,2730,2894,51,750
01/01/2012 12:00:00 AM,"Richmond city, Virginia",83775,36905,46870,51,760
01/01/2012 12:00:00 AM,"Roanoke city, Virginia",42644,23738,18906,51,770
01/01/2012 12:00:00 AM,"Salem city, Virginia",9953,6681,3272,51,775
01/01/2012 12:00:00 AM,"Staunton city, Virginia",10613,6249,4364,51,790
01/01/2012 12:00:00 AM,"Suffolk city, Virginia",30502,22789,7713,51,800
01/01/2012 12:00:00 AM,"Virginia Beach city, Virginia",164226,106510,57716,51,810
01/01/2012 12:00:00 AM,"Waynesboro city, Virginia",8734,5208,3526,51,820
01/01/2012 12:00:00 AM,"Williamsburg city, Virginia",4281,1859,2422,51,830
01/01/2012 12:00:00 AM,"Winchester city, Virginia",10454,5171,5283,51,840
01/01/2017 12:00:00 AM,"Charles City County, Virginia",2899,2415,484,51,036
01/01/2017 12:00:00 AM,"Culpeper County, Virginia",16837,12272,4565,51,047
01/01/2017 12:00:00 AM,"Dinwiddie County, Virginia",10347,7982,2365,51,053
01/01/2017 12:00:00 AM,"Greene County, Virginia",7260,5852,1408,51,079
01/01/2017 12:00:00 AM,"Hanover County, Virginia",38208,31070,7138,51,085
01/01/2017 12:00:00 AM,"Lunenburg County, Virginia",4480,3227,1253,51,111
01/01/2017 12:00:00 AM,"Orange County, Virginia",13470,10406,3064,51,137
01/01/2017 12:00:00 AM,"Emporia city, Virginia",2119,902,1217,51,595
01/01/2017 12:00:00 AM,"Wythe County, Virginia",11892,9036,2856,51,197
01/01/2017 12:00:00 AM,"Chesapeake city, Virginia",83031,58843,24188,51,550
01/01/2017 12:00:00 AM,"Colonial Heights city, Virginia",7092,4471,2621,51,570
01/01/2017 12:00:00 AM,"Harrisonburg city, Virginia",16848,6445,10403,51,660
01/01/2017 12:00:00 AM,"Albemarle County, Virginia",40015,25459,14556,51,003
01/01/2017 12:00:00 AM,"Bland County, Virginia",2561,2116,445,51,021
01/01/2017 12:00:00 AM,"Bedford County, Virginia",30927,25167,5760,51,019
01/01/2017 12:00:00 AM,"Botetourt County, Virginia",13238,11274,1964,51,023
01/01/2017 12:00:00 AM,"Buckingham County, Virginia",5705,4298,1407,51,029
01/01/2017 12:00:00 AM,"Wise County, Virginia",15104,10455,4649,51,195
01/01/2017 12:00:00 AM,"Bristol city, Virginia",7418,4372,3046,51,520
01/01/2017 12:00:00 AM,"Covington city, Virginia",2399,1805,594,51,580
01/01/2017 12:00:00 AM,"Portsmouth city, Virginia",36616,19936,16680,51,740
01/01/2017 12:00:00 AM,"Williamsburg city, Virginia",4649,2198,2451,51,830
01/01/2017 12:00:00 AM,"Virginia Beach city, Virginia",167731,107096,60635,51,810
01/01/2017 12:00:00 AM,"Alleghany County, Virginia",6866,5225,1641,51,005
01/01/2017 12:00:00 AM,"Carroll County, Virginia",12517,9760,2757,51,035
01/01/2017 12:00:00 AM,"Galax city, Virginia",2837,1674,1163,51,640
01/01/2017 12:00:00 AM,"Washington County, Virginia",22388,16926,5462,51,191
01/01/2017 12:00:00 AM,"Westmoreland County, Virginia",7412,5695,1717,51,193
01/01/2017 12:00:00 AM,"Northumberland County, Virginia",5774,4917,857,51,133
01/01/2017 12:00:00 AM,"Page County, Virginia",9467,6525,2942,51,139
01/01/2017 12:00:00 AM,"Pulaski County, Virginia",14577,10615,3962,51,155
01/01/2017 12:00:00 AM,"Warren County, Virginia",14190,10887,3303,51,187
01/01/2017 12:00:00 AM,"Alexandria city, Virginia",68663,29576,39087,51,510
01/01/2017 12:00:00 AM,"Danville city, Virginia",18517,9844,8673,51,590
01/01/2017 12:00:00 AM,"Fredericksburg city, Virginia",10419,3746,6673,51,630
01/01/2017 12:00:00 AM,"Hampton city, Virginia",53555,30471,23084,51,650
01/01/2017 12:00:00 AM,"Amherst County, Virginia",12110,9313,2797,51,009
01/01/2017 12:00:00 AM,"Arlington County, Virginia",102310,45525,56785,51,013
01/01/2017 12:00:00 AM,"Bath County, Virginia",1847,1365,482,51,017
01/01/2017 12:00:00 AM,"Hopewell city, Virginia",9123,4653,4470,51,670
01/01/2017 12:00:00 AM,"Buchanan County, Virginia",9022,7116,1906,51,027
01/01/2017 12:00:00 AM,"Newport News city, Virginia",68665,34345,34320,51,700
01/01/2017 12:00:00 AM,"Frederick County, Virginia",30495,23620,6875,51,069
01/01/2017 12:00:00 AM,"Stafford County, Virginia",45345,34377,10968,51,179
01/01/2017 12:00:00 AM,"Lynchburg city, Virginia",28150,13978,14172,51,680
01/01/2017 12:00:00 AM,"York County, Virginia",24333,17547,6786,51,199
01/01/2017 12:00:00 AM,"Richmond city, Virginia",89238,37190,52048,51,760
01/01/2017 12:00:00 AM,"Martinsville city, Virginia",5740,3165,2575,51,690
01/01/2017 12:00:00 AM,"Nelson County, Virginia",6523,4685,1838,51,125
01/01/2017 12:00:00 AM,"Essex County, Virginia",4470,3153,1317,51,057
01/01/2017 12:00:00 AM,"Pittsylvania County, Virginia",26687,20068,6619,51,143
01/01/2017 12:00:00 AM,"Norton city, Virginia",1786,868,918,51,720
01/01/2017 12:00:00 AM,"Staunton city, Virginia",10477,6026,4451,51,790
01/01/2017 12:00:00 AM,"Fluvanna County, Virginia",9794,7911,1883,51,065
01/01/2017 12:00:00 AM,"Amelia County, Virginia",4699,3928,771,51,007
01/01/2017 12:00:00 AM,"Radford city, Virginia",5503,2559,2944,51,750
01/01/2017 12:00:00 AM,"Winchester city, Virginia",10520,4802,5718,51,840
01/01/2017 12:00:00 AM,"Accomack County, Virginia",13528,9466,4062,51,001
01/01/2017 12:00:00 AM,"Craig County, Virginia",2344,1734,610,51,045
01/01/2017 12:00:00 AM,"Floyd County, Virginia",6434,5196,1238,51,063
01/01/2017 12:00:00 AM,"Giles County, Virginia",7088,5300,1788,51,071
01/01/2017 12:00:00 AM,"Grayson County, Virginia",6653,5238,1415,51,077
01/01/2017 12:00:00 AM,"Nottoway County, Virginia",5633,3318,2315,51,135
01/01/2017 12:00:00 AM,"Rappahannock County, Virginia",3131,2354,777,51,157
01/01/2017 12:00:00 AM,"Tazewell County, Virginia",17330,13304,4026,51,185
01/01/2017 12:00:00 AM,"Buena Vista city, Virginia",2606,1623,983,51,530
01/01/2017 12:00:00 AM,"Falls Church city, Virginia",5308,3178,2130,51,610
01/01/2017 12:00:00 AM,"Manassas Park city, Virginia",4778,3224,1554,51,685
01/01/2017 12:00:00 AM,"Petersburg city, Virginia",13262,5532,7730,51,730
01/01/2017 12:00:00 AM,"Poquoson city, Virginia",4583,3659,924,51,735
01/01/2017 12:00:00 AM,"Sussex County, Virginia",3388,2395,993,51,183
01/01/2017 12:00:00 AM,"Fairfax city, Virginia",8499,5949,2550,51,600
01/01/2017 12:00:00 AM,"Waynesboro city, Virginia",9128,5376,3752,51,820
01/01/2017 12:00:00 AM,"Manassas city, Virginia",12540,7979,4561,51,683
01/01/2017 12:00:00 AM,"Roanoke city, Virginia",42333,21977,20356,51,770
01/01/2017 12:00:00 AM,"Salem city, Virginia",9997,6551,3446,51,775
01/01/2017 12:00:00 AM,"Suffolk city, Virginia",32331,22380,9951,51,800
01/01/2017 12:00:00 AM,"Norfolk city, Virginia",87249,37854,49395,51,710
01/01/2017 12:00:00 AM,"Charlotte County, Virginia",4493,3198,1295,51,037
01/01/2017 12:00:00 AM,"Chesterfield County, Virginia",120907,91047,29860,51,041
01/01/2017 12:00:00 AM,"Fairfax County, Virginia",393380,266707,126673,51,059
01/01/2017 12:00:00 AM,"Greensville County, Virginia",3649,2754,895,51,081
01/01/2017 12:00:00 AM,"Isle of Wight County, Virginia",14157,10939,3218,51,093
01/01/2017 12:00:00 AM,"James City County, Virginia",28410,21117,7293,51,095
01/01/2017 12:00:00 AM,"Russell County, Virginia",11102,8643,2459,51,167
01/01/2017 12:00:00 AM,"Franklin city, Virginia",3470,1726,1744,51,620
01/01/2017 12:00:00 AM,"Smyth County, Virginia",12829,9015,3814,51,173
01/01/2017 12:00:00 AM,"Charlottesville city, Virginia",18408,8116,10292,51,540
01/01/2017 12:00:00 AM,"Lexington city, Virginia",1935,1147,788,51,678
01/01/2017 12:00:00 AM,"Campbell County, Virginia",22608,16947,5661,51,031
01/01/2017 12:00:00 AM,"Henrico County, Virginia",126115,79311,46804,51,087
01/01/2017 12:00:00 AM,"Henry County, Virginia",22161,16220,5941,51,089
01/01/2017 12:00:00 AM,"King George County, Virginia",8972,6780,2192,51,099
01/01/2017 12:00:00 AM,"Louisa County, Virginia",13451,10721,2730,51,109
01/01/2017 12:00:00 AM,"King William County, Virginia",6079,5233,846,51,101
01/01/2017 12:00:00 AM,"Lancaster County, Virginia",5081,3719,1362,51,103
01/01/2017 12:00:00 AM,"Lee County, Virginia",9278,6671,2607,51,105
01/01/2017 12:00:00 AM,"Mathews County, Virginia",3766,3248,518,51,115
01/01/2017 12:00:00 AM,"Middlesex County, Virginia",4522,3659,863,51,119
01/01/2017 12:00:00 AM,"Prince Edward County, Virginia",7281,4722,2559,51,147
01/01/2017 12:00:00 AM,"Prince George County, Virginia",11298,7710,3588,51,149
01/01/2017 12:00:00 AM,"Richmond County, Virginia",3250,2338,912,51,159
01/01/2017 12:00:00 AM,"Rockingham County, Virginia",30503,22351,8152,51,165
01/01/2017 12:00:00 AM,"Scott County, Virginia",8976,6931,2045,51,169
01/01/2017 12:00:00 AM,"Spotsylvania County, Virginia",43279,33482,9797,51,177
01/01/2017 12:00:00 AM,"Surry County, Virginia",2773,2110,663,51,181
01/01/2017 12:00:00 AM,"Appomattox County, Virginia",5948,4817,1131,51,011
01/01/2017 12:00:00 AM,"Clarke County, Virginia",5568,4176,1392,51,043
01/01/2017 12:00:00 AM,"Franklin County, Virginia",23203,18393,4810,51,067
01/01/2017 12:00:00 AM,"King and Queen County, Virginia",2811,2213,598,51,097
01/01/2017 12:00:00 AM,"Mecklenburg County, Virginia",11785,8503,3282,51,117
01/01/2017 12:00:00 AM,"Montgomery County, Virginia",35577,19520,16057,51,121
01/01/2017 12:00:00 AM,"New Kent County, Virginia",7555,6182,1373,51,127
01/01/2017 12:00:00 AM,"Augusta County, Virginia",28790,22774,6016,51,015
01/01/2017 12:00:00 AM,"Cumberland County, Virginia",3972,2870,1102,51,049
01/01/2017 12:00:00 AM,"Dickenson County, Virginia",6096,4630,1466,51,051
01/01/2017 12:00:00 AM,"Goochland County, Virginia",8257,7186,1071,51,075
01/01/2017 12:00:00 AM,"Halifax County, Virginia",14084,10220,3864,51,083
01/01/2017 12:00:00 AM,"Loudoun County, Virginia",121299,94437,26862,51,107
01/01/2017 12:00:00 AM,"Madison County, Virginia",5107,3749,1358,51,113
01/01/2017 12:00:00 AM,"Prince William County, Virginia",139306,100948,38358,51,153
01/01/2017 12:00:00 AM,"Roanoke County, Virginia",38434,28751,9683,51,161
01/01/2017 12:00:00 AM,"Southampton County, Virginia",6664,4773,1891,51,175
01/01/2017 12:00:00 AM,"Highland County, Virginia",1163,994,169,51,091
01/01/2017 12:00:00 AM,"Brunswick County, Virginia",6048,4472,1576,51,025
01/01/2017 12:00:00 AM,"Caroline County, Virginia",10815,8668,2147,51,033
01/01/2017 12:00:00 AM,"Gloucester County, Virginia",14746,11378,3368,51,073
01/01/2017 12:00:00 AM,"Northampton County, Virginia",5177,3344,1833,51,131
01/01/2017 12:00:00 AM,"Patrick County, Virginia",7713,5942,1771,51,141
01/01/2017 12:00:00 AM,"Powhatan County, Virginia",9974,8954,1020,51,145
01/01/2017 12:00:00 AM,"Rockbridge County, Virginia",9160,7040,2120,51,163
01/01/2017 12:00:00 AM,"Shenandoah County, Virginia",17262,12035,5227,51,171
01/01/2017 12:00:00 AM,"Fauquier County, Virginia",23981,18803,5178,51,061
01/01/2013 12:00:00 AM,"Accomack County, Virginia",14333,9960,4373,51,001
01/01/2013 12:00:00 AM,"Albemarle County, Virginia",37964,25078,12886,51,003
01/01/2013 12:00:00 AM,"Alleghany County, Virginia",6773,5413,1360,51,005
01/01/2013 12:00:00 AM,"Amelia County, Virginia",4808,3843,965,51,007
01/01/2013 12:00:00 AM,"Amherst County, Virginia",12680,9402,3278,51,009
01/01/2013 12:00:00 AM,"Appomattox County, Virginia",5803,4654,1149,51,011
01/01/2013 12:00:00 AM,"Arlington County, Virginia",94454,42654,51800,51,013
01/01/2013 12:00:00 AM,"Augusta County, Virginia",27999,22662,5337,51,015
01/01/2013 12:00:00 AM,"Bath County, Virginia",2101,1600,501,51,017
01/01/2013 12:00:00 AM,"Bedford County, Virginia",27233,23157,4076,51,019
01/01/2013 12:00:00 AM,"Bland County, Virginia",2480,2045,435,51,021
01/01/2013 12:00:00 AM,"Botetourt County, Virginia",12825,11296,1529,51,023
01/01/2013 12:00:00 AM,"Brunswick County, Virginia",5826,4207,1619,51,025
01/01/2013 12:00:00 AM,"Buchanan County, Virginia",9485,7458,2027,51,027
01/01/2013 12:00:00 AM,"Buckingham County, Virginia",5817,4420,1397,51,029
01/01/2013 12:00:00 AM,"Campbell County, Virginia",21774,16545,5229,51,031
01/01/2013 12:00:00 AM,"Caroline County, Virginia",10680,8553,2127,51,033
01/01/2013 12:00:00 AM,"Carroll County, Virginia",12572,9889,2683,51,035
01/01/2013 12:00:00 AM,"Charles City County, Virginia",2850,2294,556,51,036
01/01/2013 12:00:00 AM,"Charlotte County, Virginia",4751,3469,1282,51,037
01/01/2013 12:00:00 AM,"Chesterfield County, Virginia",113637,87479,26158,51,041
01/01/2013 12:00:00 AM,"Clarke County, Virginia",5580,4447,1133,51,043
01/01/2013 12:00:00 AM,"Craig County, Virginia",2122,1791,331,51,045
01/01/2013 12:00:00 AM,"Culpeper County, Virginia",16039,11711,4328,51,047
01/01/2013 12:00:00 AM,"Cumberland County, Virginia",4049,3134,915,51,049
01/01/2013 12:00:00 AM,"Dickenson County, Virginia",6352,4960,1392,51,051
01/01/2013 12:00:00 AM,"Dinwiddie County, Virginia",9932,7607,2325,51,053
01/01/2013 12:00:00 AM,"Essex County, Virginia",4286,3265,1021,51,057
01/01/2013 12:00:00 AM,"Fairfax County, Virginia",389908,269167,120741,51,059
01/01/2013 12:00:00 AM,"Fauquier County, Virginia",23130,18530,4600,51,061
01/01/2013 12:00:00 AM,"Floyd County, Virginia",6086,4720,1366,51,063
01/01/2013 12:00:00 AM,"Fluvanna County, Virginia",9462,8094,1368,51,065
01/01/2013 12:00:00 AM,"Franklin County, Virginia",23358,18230,5128,51,067
01/01/2013 12:00:00 AM,"Frederick County, Virginia",29172,22852,6320,51,069
01/01/2013 12:00:00 AM,"Giles County, Virginia",7167,5442,1725,51,071
01/01/2013 12:00:00 AM,"Gloucester County, Virginia",13889,11519,2370,51,073
01/01/2013 12:00:00 AM,"Goochland County, Virginia",8058,7271,787,51,075
01/01/2013 12:00:00 AM,"Grayson County, Virginia",6618,5140,1478,51,077
01/01/2013 12:00:00 AM,"Greene County, Virginia",6897,5448,1449,51,079
01/01/2013 12:00:00 AM,"Greensville County, Virginia",3389,2568,821,51,081
01/01/2013 12:00:00 AM,"Halifax County, Virginia",14770,10672,4098,51,083
01/01/2013 12:00:00 AM,"Hanover County, Virginia",36927,30780,6147,51,085
01/01/2013 12:00:00 AM,"Henrico County, Virginia",123683,80690,42993,51,087
01/01/2013 12:00:00 AM,"Henry County, Virginia",22690,16919,5771,51,089
01/01/2013 12:00:00 AM,"Highland County, Virginia",1006,868,138,51,091
01/01/2013 12:00:00 AM,"Isle of Wight County, Virginia",13560,10926,2634,51,093
01/01/2013 12:00:00 AM,"James City County, Virginia",26883,20490,6393,51,095
01/01/2013 12:00:00 AM,"King and Queen County, Virginia",2863,2183,680,51,097
01/01/2013 12:00:00 AM,"King George County, Virginia",8314,6114,2200,51,099
01/01/2013 12:00:00 AM,"King William County, Virginia",5998,4982,1016,51,101
01/01/2013 12:00:00 AM,"Lancaster County, Virginia",5182,4106,1076,51,103
01/01/2013 12:00:00 AM,"Lee County, Virginia",9653,7177,2476,51,105
01/01/2013 12:00:00 AM,"Loudoun County, Virginia",106997,83100,23897,51,107
01/01/2013 12:00:00 AM,"Louisa County, Virginia",13046,10422,2624,51,109
01/01/2013 12:00:00 AM,"Lunenburg County, Virginia",4572,3444,1128,51,111
01/01/2013 12:00:00 AM,"Madison County, Virginia",5024,4032,992,51,113
01/01/2013 12:00:00 AM,"Mathews County, Virginia",3856,3078,778,51,115
01/01/2013 12:00:00 AM,"Mecklenburg County, Virginia",12650,9282,3368,51,117
01/01/2013 12:00:00 AM,"Middlesex County, Virginia",4400,3606,794,51,119
01/01/2013 12:00:00 AM,"Montgomery County, Virginia",34789,19012,15777,51,121
01/01/2013 12:00:00 AM,"Nelson County, Virginia",6404,4856,1548,51,125
01/01/2013 12:00:00 AM,"New Kent County, Virginia",6886,6127,759,51,127
01/01/2013 12:00:00 AM,"Northampton County, Virginia",5149,3533,1616,51,131
01/01/2013 12:00:00 AM,"Northumberland County, Virginia",5691,4839,852,51,133
01/01/2013 12:00:00 AM,"Nottoway County, Virginia",5673,3674,1999,51,135
01/01/2013 12:00:00 AM,"Orange County, Virginia",12621,9576,3045,51,137
01/01/2013 12:00:00 AM,"Page County, Virginia",9623,6930,2693,51,139
01/01/2013 12:00:00 AM,"Patrick County, Virginia",7846,6041,1805,51,141
01/01/2013 12:00:00 AM,"Pittsylvania County, Virginia",26092,20787,5305,51,143
01/01/2013 12:00:00 AM,"Powhatan County, Virginia",9544,8466,1078,51,145
01/01/2013 12:00:00 AM,"Prince Edward County, Virginia",7453,4856,2597,51,147
01/01/2013 12:00:00 AM,"Prince George County, Virginia",10848,7803,3045,51,149
01/01/2013 12:00:00 AM,"Prince William County, Virginia",132442,95506,36936,51,153
01/01/2013 12:00:00 AM,"Pulaski County, Virginia",14875,10816,4059,51,155
01/01/2013 12:00:00 AM,"Rappahannock County, Virginia",3261,2553,708,51,157
01/01/2013 12:00:00 AM,"Richmond County, Virginia",2853,2138,715,51,159
01/01/2013 12:00:00 AM,"Roanoke County, Virginia",37928,29098,8830,51,161
01/01/2013 12:00:00 AM,"Rockbridge County, Virginia",9234,6761,2473,51,163
01/01/2013 12:00:00 AM,"Rockingham County, Virginia",29440,22603,6837,51,165
01/01/2013 12:00:00 AM,"Russell County, Virginia",11191,8750,2441,51,167
01/01/2013 12:00:00 AM,"Scott County, Virginia",9692,7461,2231,51,169
01/01/2013 12:00:00 AM,"Shenandoah County, Virginia",17397,12259,5138,51,171
01/01/2013 12:00:00 AM,"Smyth County, Virginia",12650,8950,3700,51,173
01/01/2013 12:00:00 AM,"Southampton County, Virginia",6708,4815,1893,51,175
01/01/2013 12:00:00 AM,"Spotsylvania County, Virginia",41709,32318,9391,51,177
01/01/2013 12:00:00 AM,"Stafford County, Virginia",42178,32435,9743,51,179
01/01/2013 12:00:00 AM,"Surry County, Virginia",2602,2080,522,51,181
01/01/2013 12:00:00 AM,"Sussex County, Virginia",3704,2600,1104,51,183
01/01/2013 12:00:00 AM,"Tazewell County, Virginia",18294,13353,4941,51,185
01/01/2013 12:00:00 AM,"Warren County, Virginia",14387,10436,3951,51,187
01/01/2013 12:00:00 AM,"Washington County, Virginia",22755,17242,5513,51,191
01/01/2013 12:00:00 AM,"Westmoreland County, Virginia",7130,5553,1577,51,193
01/01/2013 12:00:00 AM,"Wise County, Virginia",15406,10913,4493,51,195
01/01/2013 12:00:00 AM,"Wythe County, Virginia",11656,8585,3071,51,197
01/01/2013 12:00:00 AM,"York County, Virginia",24071,18068,6003,51,199
01/01/2013 12:00:00 AM,"Alexandria city, Virginia",65369,28337,37032,51,510
01/01/2013 12:00:00 AM,"Bedford city, Virginia",2800,1644,1156,51,515
01/01/2013 12:00:00 AM,"Bristol city, Virginia",7674,4495,3179,51,520
01/01/2013 12:00:00 AM,"Buena Vista city, Virginia",2738,1810,928,51,530
01/01/2013 12:00:00 AM,"Charlottesville city, Virginia",17443,7071,10372,51,540
01/01/2013 12:00:00 AM,"Chesapeake city, Virginia",79421,57579,21842,51,550
01/01/2013 12:00:00 AM,"Colonial Heights city, Virginia",7017,4493,2524,51,570
01/01/2013 12:00:00 AM,"Covington city, Virginia",2545,1855,690,51,580
01/01/2013 12:00:00 AM,"Danville city, Virginia",18659,10156,8503,51,590
01/01/2013 12:00:00 AM,"Emporia city, Virginia",2488,1132,1356,51,595
01/01/2013 12:00:00 AM,"Fairfax city, Virginia",8492,5812,2680,51,600
01/01/2013 12:00:00 AM,"Falls Church city, Virginia",5020,2981,2039,51,610
01/01/2013 12:00:00 AM,"Franklin city, Virginia",3551,1509,2042,51,620
01/01/2013 12:00:00 AM,"Fredericksburg city, Virginia",9779,3721,6058,51,630
01/01/2013 12:00:00 AM,"Galax city, Virginia",3018,1965,1053,51,640
01/01/2013 12:00:00 AM,"Hampton city, Virginia",52511,31560,20951,51,650
01/01/2013 12:00:00 AM,"Harrisonburg city, Virginia",15701,5680,10021,51,660
01/01/2013 12:00:00 AM,"Hopewell city, Virginia",8766,4419,4347,51,670
01/01/2013 12:00:00 AM,"Lexington city, Virginia",1709,949,760,51,678
01/01/2013 12:00:00 AM,"Lynchburg city, Virginia",28556,15061,13495,51,680
01/01/2013 12:00:00 AM,"Manassas city, Virginia",12072,7865,4207,51,683
01/01/2013 12:00:00 AM,"Manassas Park city, Virginia",4435,2825,1610,51,685
01/01/2013 12:00:00 AM,"Martinsville city, Virginia",5995,3220,2775,51,690
01/01/2013 12:00:00 AM,"Newport News city, Virginia",69211,35601,33610,51,700
01/01/2013 12:00:00 AM,"Norfolk city, Virginia",85557,38066,47491,51,710
01/01/2013 12:00:00 AM,"Norton city, Virginia",1706,899,807,51,720
01/01/2013 12:00:00 AM,"Petersburg city, Virginia",12456,5694,6762,51,730
01/01/2013 12:00:00 AM,"Poquoson city, Virginia",4591,3755,836,51,735
01/01/2013 12:00:00 AM,"Portsmouth city, Virginia",36690,20997,15693,51,740
01/01/2013 12:00:00 AM,"Radford city, Virginia",5516,2546,2970,51,750
01/01/2013 12:00:00 AM,"Richmond city, Virginia",84833,36547,48286,51,760
01/01/2013 12:00:00 AM,"Roanoke city, Virginia",42494,23271,19223,51,770
01/01/2013 12:00:00 AM,"Salem city, Virginia",9908,6599,3309,51,775
01/01/2013 12:00:00 AM,"Staunton city, Virginia",10495,6054,4441,51,790
01/01/2013 12:00:00 AM,"Suffolk city, Virginia",30492,22373,8119,51,800
01/01/2013 12:00:00 AM,"Virginia Beach city, Virginia",164944,105839,59105,51,810
01/01/2013 12:00:00 AM,"Waynesboro city, Virginia",8708,5067,3641,51,820
01/01/2013 12:00:00 AM,"Williamsburg city, Virginia",4391,1962,2429,51,830
01/01/2013 12:00:00 AM,"Winchester city, Virginia",10393,5055,5338,51,840
01/01/2014 12:00:00 AM,"Accomack County, Virginia",14289,10053,4236,51,001
01/01/2014 12:00:00 AM,"Albemarle County, Virginia",38537,25135,13402,51,003
01/01/2014 12:00:00 AM,"Alleghany County, Virginia",6714,5337,1377,51,005
01/01/2014 12:00:00 AM,"Amelia County, Virginia",4761,3886,875,51,007
01/01/2014 12:00:00 AM,"Amherst County, Virginia",12577,9373,3204,51,009
01/01/2014 12:00:00 AM,"Appomattox County, Virginia",5964,4839,1125,51,011
01/01/2014 12:00:00 AM,"Arlington County, Virginia",96264,43157,53107,51,013
01/01/2014 12:00:00 AM,"Augusta County, Virginia",28124,22813,5311,51,015
01/01/2014 12:00:00 AM,"Bath County, Virginia",2225,1674,551,51,017
01/01/2014 12:00:00 AM,"Bedford County, Virginia",30122,24628,5494,51,019
01/01/2014 12:00:00 AM,"Bland County, Virginia",2591,2078,513,51,021
01/01/2014 12:00:00 AM,"Botetourt County, Virginia",12867,11366,1501,51,023
01/01/2014 12:00:00 AM,"Brunswick County, Virginia",5865,4335,1530,51,025
01/01/2014 12:00:00 AM,"Buchanan County, Virginia",9406,7576,1830,51,027
01/01/2014 12:00:00 AM,"Buckingham County, Virginia",5802,4431,1371,51,029
01/01/2014 12:00:00 AM,"Campbell County, Virginia",21728,16761,4967,51,031
01/01/2014 12:00:00 AM,"Caroline County, Virginia",10728,8737,1991,51,033
01/01/2014 12:00:00 AM,"Carroll County, Virginia",12508,9846,2662,51,035
01/01/2014 12:00:00 AM,"Charles City County, Virginia",2832,2279,553,51,036
01/01/2014 12:00:00 AM,"Charlotte County, Virginia",4691,3416,1275,51,037
01/01/2014 12:00:00 AM,"Chesterfield County, Virginia",115005,88056,26949,51,041
01/01/2014 12:00:00 AM,"Clarke County, Virginia",5619,4275,1344,51,043
01/01/2014 12:00:00 AM,"Craig County, Virginia",2151,1733,418,51,045
01/01/2014 12:00:00 AM,"Culpeper County, Virginia",16436,12039,4397,51,047
01/01/2014 12:00:00 AM,"Cumberland County, Virginia",4038,3070,968,51,049
01/01/2014 12:00:00 AM,"Dickenson County, Virginia",6200,4836,1364,51,051
01/01/2014 12:00:00 AM,"Dinwiddie County, Virginia",9956,7467,2489,51,053
01/01/2014 12:00:00 AM,"Essex County, Virginia",4288,3184,1104,51,057
01/01/2014 12:00:00 AM,"Fairfax County, Virginia",391794,267156,124638,51,059
01/01/2014 12:00:00 AM,"Fauquier County, Virginia",23162,18417,4745,51,061
01/01/2014 12:00:00 AM,"Floyd County, Virginia",6086,4791,1295,51,063
01/01/2014 12:00:00 AM,"Fluvanna County, Virginia",9787,8150,1637,51,065
01/01/2014 12:00:00 AM,"Franklin County, Virginia",23248,18072,5176,51,067
01/01/2014 12:00:00 AM,"Frederick County, Virginia",29184,22682,6502,51,069
01/01/2014 12:00:00 AM,"Giles County, Virginia",7253,5482,1771,51,071
01/01/2014 12:00:00 AM,"Gloucester County, Virginia",14074,11377,2697,51,073
01/01/2014 12:00:00 AM,"Goochland County, Virginia",8212,7194,1018,51,075
01/01/2014 12:00:00 AM,"Grayson County, Virginia",6686,5079,1607,51,077
01/01/2014 12:00:00 AM,"Greene County, Virginia",6965,5353,1612,51,079
01/01/2014 12:00:00 AM,"Greensville County, Virginia",3397,2482,915,51,081
01/01/2014 12:00:00 AM,"Halifax County, Virginia",14472,10574,3898,51,083
01/01/2014 12:00:00 AM,"Hanover County, Virginia",37041,30490,6551,51,085
01/01/2014 12:00:00 AM,"Henrico County, Virginia",123821,79065,44756,51,087
01/01/2014 12:00:00 AM,"Henry County, Virginia",22472,16657,5815,51,089
01/01/2014 12:00:00 AM,"Highland County, Virginia",1067,911,156,51,091
01/01/2014 12:00:00 AM,"Isle of Wight County, Virginia",13519,10679,2840,51,093
01/01/2014 12:00:00 AM,"James City County, Virginia",27665,20616,7049,51,095
01/01/2014 12:00:00 AM,"King and Queen County, Virginia",2832,2121,711,51,097
01/01/2014 12:00:00 AM,"King George County, Virginia",8315,6114,2201,51,099
01/01/2014 12:00:00 AM,"King William County, Virginia",6147,5051,1096,51,101
01/01/2014 12:00:00 AM,"Lancaster County, Virginia",5283,3984,1299,51,103
01/01/2014 12:00:00 AM,"Lee County, Virginia",9597,6954,2643,51,105
01/01/2014 12:00:00 AM,"Loudoun County, Virginia",110047,84662,25385,51,107
01/01/2014 12:00:00 AM,"Louisa County, Virginia",12811,10397,2414,51,109
01/01/2014 12:00:00 AM,"Lunenburg County, Virginia",4634,3429,1205,51,111
01/01/2014 12:00:00 AM,"Madison County, Virginia",5093,3982,1111,51,113
01/01/2014 12:00:00 AM,"Mathews County, Virginia",3792,3082,710,51,115
01/01/2014 12:00:00 AM,"Mecklenburg County, Virginia",12857,9408,3449,51,117
01/01/2014 12:00:00 AM,"Middlesex County, Virginia",4432,3691,741,51,119
01/01/2014 12:00:00 AM,"Montgomery County, Virginia",34803,18850,15953,51,121
01/01/2014 12:00:00 AM,"Nelson County, Virginia",6381,4715,1666,51,125
01/01/2014 12:00:00 AM,"New Kent County, Virginia",7106,6253,853,51,127
01/01/2014 12:00:00 AM,"Northampton County, Virginia",5237,3662,1575,51,131
01/01/2014 12:00:00 AM,"Northumberland County, Virginia",5669,4730,939,51,133
01/01/2014 12:00:00 AM,"Nottoway County, Virginia",5640,3609,2031,51,135
01/01/2014 12:00:00 AM,"Orange County, Virginia",12433,9543,2890,51,137
01/01/2014 12:00:00 AM,"Page County, Virginia",9526,6764,2762,51,139
01/01/2014 12:00:00 AM,"Patrick County, Virginia",7678,5840,1838,51,141
01/01/2014 12:00:00 AM,"Pittsylvania County, Virginia",26029,20420,5609,51,143
01/01/2014 12:00:00 AM,"Powhatan County, Virginia",9590,8425,1165,51,145
01/01/2014 12:00:00 AM,"Prince Edward County, Virginia",7604,5021,2583,51,147
01/01/2014 12:00:00 AM,"Prince George County, Virginia",10906,7683,3223,51,149
01/01/2014 12:00:00 AM,"Prince William County, Virginia",134737,96757,37980,51,153
01/01/2014 12:00:00 AM,"Pulaski County, Virginia",15125,11036,4089,51,155
01/01/2014 12:00:00 AM,"Rappahannock County, Virginia",3281,2600,681,51,157
01/01/2014 12:00:00 AM,"Richmond County, Virginia",2800,2122,678,51,159
01/01/2014 12:00:00 AM,"Roanoke County, Virginia",38197,28749,9448,51,161
01/01/2014 12:00:00 AM,"Rockbridge County, Virginia",9226,6928,2298,51,163
01/01/2014 12:00:00 AM,"Rockingham County, Virginia",29483,22529,6954,51,165
01/01/2014 12:00:00 AM,"Russell County, Virginia",11037,8599,2438,51,167
01/01/2014 12:00:00 AM,"Scott County, Virginia",9363,7361,2002,51,169
01/01/2014 12:00:00 AM,"Shenandoah County, Virginia",17246,12381,4865,51,171
01/01/2014 12:00:00 AM,"Smyth County, Virginia",12852,8946,3906,51,173
01/01/2014 12:00:00 AM,"Southampton County, Virginia",6654,4777,1877,51,175
01/01/2014 12:00:00 AM,"Spotsylvania County, Virginia",42280,32204,10076,51,177
01/01/2014 12:00:00 AM,"Stafford County, Virginia",42763,32769,9994,51,179
01/01/2014 12:00:00 AM,"Surry County, Virginia",2652,2088,564,51,181
01/01/2014 12:00:00 AM,"Sussex County, Virginia",3261,2124,1137,51,183
01/01/2014 12:00:00 AM,"Tazewell County, Virginia",18306,13447,4859,51,185
01/01/2014 12:00:00 AM,"Warren County, Virginia",14324,10708,3616,51,187
01/01/2014 12:00:00 AM,"Washington County, Virginia",22842,17600,5242,51,191
01/01/2014 12:00:00 AM,"Westmoreland County, Virginia",6981,5381,1600,51,193
01/01/2014 12:00:00 AM,"Wise County, Virginia",15517,10739,4778,51,195
01/01/2014 12:00:00 AM,"Wythe County, Virginia",11984,8485,3499,51,197
01/01/2014 12:00:00 AM,"York County, Virginia",23970,17619,6351,51,199
01/01/2014 12:00:00 AM,"Alexandria city, Virginia",65916,28146,37770,51,510
01/01/2014 12:00:00 AM,"Bristol city, Virginia",7764,4292,3472,51,520
01/01/2014 12:00:00 AM,"Buena Vista city, Virginia",2741,1757,984,51,530
01/01/2014 12:00:00 AM,"Charlottesville city, Virginia",17604,7329,10275,51,540
01/01/2014 12:00:00 AM,"Chesapeake city, Virginia",80388,57644,22744,51,550
01/01/2014 12:00:00 AM,"Colonial Heights city, Virginia",7025,4542,2483,51,570
01/01/2014 12:00:00 AM,"Covington city, Virginia",2468,1853,615,51,580
01/01/2014 12:00:00 AM,"Danville city, Virginia",18520,10023,8497,51,590
01/01/2014 12:00:00 AM,"Emporia city, Virginia",2420,951,1469,51,595
01/01/2014 12:00:00 AM,"Fairfax city, Virginia",8480,5944,2536,51,600
01/01/2014 12:00:00 AM,"Falls Church city, Virginia",4966,2933,2033,51,610
01/01/2014 12:00:00 AM,"Franklin city, Virginia",3580,1559,2021,51,620
01/01/2014 12:00:00 AM,"Fredericksburg city, Virginia",9849,3561,6288,51,630
01/01/2014 12:00:00 AM,"Galax city, Virginia",2968,1757,1211,51,640
01/01/2014 12:00:00 AM,"Hampton city, Virginia",52700,30968,21732,51,650
01/01/2014 12:00:00 AM,"Harrisonburg city, Virginia",15881,5671,10210,51,660
01/01/2014 12:00:00 AM,"Hopewell city, Virginia",8774,4634,4140,51,670
01/01/2014 12:00:00 AM,"Lexington city, Virginia",1727,936,791,51,678
01/01/2014 12:00:00 AM,"Lynchburg city, Virginia",28424,14795,13629,51,680
01/01/2014 12:00:00 AM,"Manassas city, Virginia",12274,7936,4338,51,683
01/01/2014 12:00:00 AM,"Manassas Park city, Virginia",4526,2893,1633,51,685
01/01/2014 12:00:00 AM,"Martinsville city, Virginia",5974,3283,2691,51,690
01/01/2014 12:00:00 AM,"Newport News city, Virginia",68987,34930,34057,51,700
01/01/2014 12:00:00 AM,"Norfolk city, Virginia",86397,37731,48666,51,710
01/01/2014 12:00:00 AM,"Norton city, Virginia",1655,878,777,51,720
01/01/2014 12:00:00 AM,"Petersburg city, Virginia",12515,5583,6932,51,730
01/01/2014 12:00:00 AM,"Poquoson city, Virginia",4627,3763,864,51,735
01/01/2014 12:00:00 AM,"Portsmouth city, Virginia",36764,20528,16236,51,740
01/01/2014 12:00:00 AM,"Radford city, Virginia",5333,2518,2815,51,750
01/01/2014 12:00:00 AM,"Richmond city, Virginia",85913,36704,49209,51,760
01/01/2014 12:00:00 AM,"Roanoke city, Virginia",42549,23204,19345,51,770
01/01/2014 12:00:00 AM,"Salem city, Virginia",9953,6709,3244,51,775
01/01/2014 12:00:00 AM,"Staunton city, Virginia",10503,6076,4427,51,790
01/01/2014 12:00:00 AM,"Suffolk city, Virginia",30798,22044,8754,51,800
01/01/2014 12:00:00 AM,"Virginia Beach city, Virginia",165296,105999,59297,51,810
01/01/2014 12:00:00 AM,"Waynesboro city, Virginia",8878,5106,3772,51,820
01/01/2014 12:00:00 AM,"Williamsburg city, Virginia",4365,2023,2342,51,830
01/01/2014 12:00:00 AM,"Winchester city, Virginia",10692,5095,5597,51,840
01/01/2010 12:00:00 AM,"Accomack County, Virginia",14085,10436,3649,51,001
01/01/2010 12:00:00 AM,"Albemarle County, Virginia",37459,24510,12949,51,003
01/01/2010 12:00:00 AM,"Alleghany County, Virginia",6964,5758,1206,51,005
01/01/2010 12:00:00 AM,"Amelia County, Virginia",4901,4080,821,51,007
01/01/2010 12:00:00 AM,"Amherst County, Virginia",12706,9576,3130,51,009
01/01/2010 12:00:00 AM,"Appomattox County, Virginia",5976,4539,1437,51,011
01/01/2010 12:00:00 AM,"Arlington County, Virginia",91892,43168,48724,51,013
01/01/2010 12:00:00 AM,"Augusta County, Virginia",27909,22683,5226,51,015
01/01/2010 12:00:00 AM,"Bath County, Virginia",2025,1761,264,51,017
01/01/2010 12:00:00 AM,"Bedford County, Virginia",27150,22933,4217,51,019
01/01/2010 12:00:00 AM,"Bland County, Virginia",2580,2189,391,51,021
01/01/2010 12:00:00 AM,"Botetourt County, Virginia",12918,11264,1654,51,023
01/01/2010 12:00:00 AM,"Brunswick County, Virginia",6086,4263,1823,51,025
01/01/2010 12:00:00 AM,"Buchanan County, Virginia",9123,7254,1869,51,027
01/01/2010 12:00:00 AM,"Buckingham County, Virginia",4859,3632,1227,51,029
01/01/2010 12:00:00 AM,"Campbell County, Virginia",22005,16657,5348,51,031
01/01/2010 12:00:00 AM,"Caroline County, Virginia",10270,8517,1753,51,033
01/01/2010 12:00:00 AM,"Carroll County, Virginia",12818,9770,3048,51,035
01/01/2010 12:00:00 AM,"Charles City County, Virginia",2713,2306,407,51,036
01/01/2010 12:00:00 AM,"Charlotte County, Virginia",4415,3440,975,51,037
01/01/2010 12:00:00 AM,"Chesterfield County, Virginia",112404,88092,24312,51,041
01/01/2010 12:00:00 AM,"Clarke County, Virginia",5535,4195,1340,51,043
01/01/2010 12:00:00 AM,"Craig County, Virginia",1989,1704,285,51,045
01/01/2010 12:00:00 AM,"Culpeper County, Virginia",15834,11498,4336,51,047
01/01/2010 12:00:00 AM,"Cumberland County, Virginia",3969,3089,880,51,049
01/01/2010 12:00:00 AM,"Dickenson County, Virginia",6170,4972,1198,51,051
01/01/2010 12:00:00 AM,"Dinwiddie County, Virginia",9800,7427,2373,51,053
01/01/2010 12:00:00 AM,"Essex County, Virginia",4466,3341,1125,51,057
01/01/2010 12:00:00 AM,"Fairfax County, Virginia",381768,274448,107320,51,059
01/01/2010 12:00:00 AM,"Fauquier County, Virginia",22369,17633,4736,51,061
01/01/2010 12:00:00 AM,"Floyd County, Virginia",6334,4970,1364,51,063
01/01/2010 12:00:00 AM,"Fluvanna County, Virginia",9128,7957,1171,51,065
01/01/2010 12:00:00 AM,"Franklin County, Virginia",23355,18324,5031,51,067
01/01/2010 12:00:00 AM,"Frederick County, Virginia",28558,22495,6063,51,069
01/01/2010 12:00:00 AM,"Giles County, Virginia",7100,5527,1573,51,071
01/01/2010 12:00:00 AM,"Gloucester County, Virginia",14014,11544,2470,51,073
01/01/2010 12:00:00 AM,"Goochland County, Virginia",6831,6233,598,51,075
01/01/2010 12:00:00 AM,"Grayson County, Virginia",6858,5573,1285,51,077
01/01/2010 12:00:00 AM,"Greene County, Virginia",6709,5357,1352,51,079
01/01/2010 12:00:00 AM,"Greensville County, Virginia",3385,2525,860,51,081
01/01/2010 12:00:00 AM,"Halifax County, Virginia",14650,11124,3526,51,083
01/01/2010 12:00:00 AM,"Hanover County, Virginia",36114,30301,5813,51,085
01/01/2010 12:00:00 AM,"Henrico County, Virginia",121767,81504,40263,51,087
01/01/2010 12:00:00 AM,"Henry County, Virginia",22909,17396,5513,51,089
01/01/2010 12:00:00 AM,"Highland County, Virginia",1130,866,264,51,091
01/01/2010 12:00:00 AM,"Isle of Wight County, Virginia",13553,10995,2558,51,093
01/01/2010 12:00:00 AM,"James City County, Virginia",25851,19772,6079,51,095
01/01/2010 12:00:00 AM,"King and Queen County, Virginia",2815,2263,552,51,097
01/01/2010 12:00:00 AM,"King George County, Virginia",8194,6261,1933,51,099
01/01/2010 12:00:00 AM,"King William County, Virginia",5909,5049,860,51,101
01/01/2010 12:00:00 AM,"Lancaster County, Virginia",5421,4180,1241,51,103
01/01/2010 12:00:00 AM,"Lee County, Virginia",9836,7263,2573,51,105
01/01/2010 12:00:00 AM,"Loudoun County, Virginia",95330,77022,18308,51,107
01/01/2010 12:00:00 AM,"Louisa County, Virginia",13253,10367,2886,51,109
01/01/2010 12:00:00 AM,"Lunenburg County, Virginia",4515,3361,1154,51,111
01/01/2010 12:00:00 AM,"Madison County, Virginia",5213,4221,992,51,113
01/01/2010 12:00:00 AM,"Mathews County, Virginia",3773,3131,642,51,115
01/01/2010 12:00:00 AM,"Mecklenburg County, Virginia",12594,9463,3131,51,117
01/01/2010 12:00:00 AM,"Middlesex County, Virginia",4303,3489,814,51,119
01/01/2010 12:00:00 AM,"Montgomery County, Virginia",34369,19387,14982,51,121
01/01/2010 12:00:00 AM,"Nelson County, Virginia",6534,5086,1448,51,125
01/01/2010 12:00:00 AM,"New Kent County, Virginia",6513,5865,648,51,127
01/01/2010 12:00:00 AM,"Northampton County, Virginia",5088,3617,1471,51,131
01/01/2010 12:00:00 AM,"Northumberland County, Virginia",5478,4619,859,51,133
01/01/2010 12:00:00 AM,"Nottoway County, Virginia",5607,3608,1999,51,135
01/01/2010 12:00:00 AM,"Orange County, Virginia",12669,9937,2732,51,137
01/01/2010 12:00:00 AM,"Page County, Virginia",9629,7282,2347,51,139
01/01/2010 12:00:00 AM,"Patrick County, Virginia",7344,5973,1371,51,141
01/01/2010 12:00:00 AM,"Pittsylvania County, Virginia",26563,21094,5469,51,143
01/01/2010 12:00:00 AM,"Powhatan County, Virginia",8637,7743,894,51,145
01/01/2010 12:00:00 AM,"Prince Edward County, Virginia",7314,4638,2676,51,147
01/01/2010 12:00:00 AM,"Prince George County, Virginia",10474,7893,2581,51,149
01/01/2010 12:00:00 AM,"Prince William County, Virginia",124879,93372,31507,51,153
01/01/2010 12:00:00 AM,"Pulaski County, Virginia",14898,10892,4006,51,155
01/01/2010 12:00:00 AM,"Rappahannock County, Virginia",3163,2294,869,51,157
01/01/2010 12:00:00 AM,"Richmond County, Virginia",3007,2402,605,51,159
01/01/2010 12:00:00 AM,"Roanoke County, Virginia",37833,29401,8432,51,161
01/01/2010 12:00:00 AM,"Rockbridge County, Virginia",9372,7160,2212,51,163
01/01/2010 12:00:00 AM,"Rockingham County, Virginia",29701,22200,7501,51,165
01/01/2010 12:00:00 AM,"Russell County, Virginia",11529,8881,2648,51,167
01/01/2010 12:00:00 AM,"Scott County, Virginia",9610,7403,2207,51,169
01/01/2010 12:00:00 AM,"Shenandoah County, Virginia",17316,12039,5277,51,171
01/01/2010 12:00:00 AM,"Smyth County, Virginia",12992,9474,3518,51,173
01/01/2010 12:00:00 AM,"Southampton County, Virginia",6571,5004,1567,51,175
01/01/2010 12:00:00 AM,"Spotsylvania County, Virginia",41009,32759,8250,51,177
01/01/2010 12:00:00 AM,"Stafford County, Virginia",40183,31502,8681,51,179
01/01/2010 12:00:00 AM,"Surry County, Virginia",2481,1840,641,51,181
01/01/2010 12:00:00 AM,"Sussex County, Virginia",3796,2544,1252,51,183
01/01/2010 12:00:00 AM,"Tazewell County, Virginia",18015,13215,4800,51,185
01/01/2010 12:00:00 AM,"Warren County, Virginia",14160,10591,3569,51,187
01/01/2010 12:00:00 AM,"Washington County, Virginia",22711,16853,5858,51,191
01/01/2010 12:00:00 AM,"Westmoreland County, Virginia",7135,5433,1702,51,193
01/01/2010 12:00:00 AM,"Wise County, Virginia",15750,10973,4777,51,195
01/01/2010 12:00:00 AM,"Wythe County, Virginia",11665,8981,2684,51,197
01/01/2010 12:00:00 AM,"York County, Virginia",24002,18871,5131,51,199
01/01/2010 12:00:00 AM,"Alexandria city, Virginia",63738,29103,34635,51,510
01/01/2010 12:00:00 AM,"Bedford city, Virginia",2782,1852,930,51,515
01/01/2010 12:00:00 AM,"Bristol city, Virginia",7948,4909,3039,51,520
01/01/2010 12:00:00 AM,"Buena Vista city, Virginia",2693,1745,948,51,530
01/01/2010 12:00:00 AM,"Charlottesville city, Virginia",17290,7143,10147,51,540
01/01/2010 12:00:00 AM,"Chesapeake city, Virginia",78778,58988,19790,51,550
01/01/2010 12:00:00 AM,"Colonial Heights city, Virginia",7075,4652,2423,51,570
01/01/2010 12:00:00 AM,"Covington city, Virginia",2641,1814,827,51,580
01/01/2010 12:00:00 AM,"Danville city, Virginia",19448,10623,8825,51,590
01/01/2010 12:00:00 AM,"Emporia city, Virginia",2406,1164,1242,51,595
01/01/2010 12:00:00 AM,"Fairfax city, Virginia",8524,6148,2376,51,600
01/01/2010 12:00:00 AM,"Falls Church city, Virginia",4706,3006,1700,51,610
01/01/2010 12:00:00 AM,"Franklin city, Virginia",3524,1631,1893,51,620
01/01/2010 12:00:00 AM,"Fredericksburg city, Virginia",9206,3592,5614,51,630
01/01/2010 12:00:00 AM,"Galax city, Virginia",3326,2105,1221,51,640
01/01/2010 12:00:00 AM,"Hampton city, Virginia",53283,31573,21710,51,650
01/01/2010 12:00:00 AM,"Harrisonburg city, Virginia",14965,5770,9195,51,660
01/01/2010 12:00:00 AM,"Hopewell city, Virginia",8914,4607,4307,51,670
01/01/2010 12:00:00 AM,"Lexington city, Virginia",2108,1079,1029,51,678
01/01/2010 12:00:00 AM,"Lynchburg city, Virginia",27875,15707,12168,51,680
01/01/2010 12:00:00 AM,"Manassas city, Virginia",11732,8003,3729,51,683
01/01/2010 12:00:00 AM,"Manassas Park city, Virginia",4206,2993,1213,51,685
01/01/2010 12:00:00 AM,"Martinsville city, Virginia",5922,3519,2403,51,690
01/01/2010 12:00:00 AM,"Newport News city, Virginia",70653,36831,33822,51,700
01/01/2010 12:00:00 AM,"Norfolk city, Virginia",85061,39675,45386,51,710
01/01/2010 12:00:00 AM,"Norton city, Virginia",1764,952,812,51,720
01/01/2010 12:00:00 AM,"Petersburg city, Virginia",12305,6252,6053,51,730
01/01/2010 12:00:00 AM,"Poquoson city, Virginia",4524,3835,689,51,735
01/01/2010 12:00:00 AM,"Portsmouth city, Virginia",37325,22970,14355,51,740
01/01/2010 12:00:00 AM,"Radford city, Virginia",5667,2927,2740,51,750
01/01/2010 12:00:00 AM,"Richmond city, Virginia",83498,37507,45991,51,760
01/01/2010 12:00:00 AM,"Roanoke city, Virginia",42833,24005,18828,51,770
01/01/2010 12:00:00 AM,"Salem city, Virginia",9890,6800,3090,51,775
01/01/2010 12:00:00 AM,"Staunton city, Virginia",10408,6290,4118,51,790
01/01/2010 12:00:00 AM,"Suffolk city, Virginia",30126,22638,7488,51,800
01/01/2010 12:00:00 AM,"Virginia Beach city, Virginia",163944,109099,54845,51,810
01/01/2010 12:00:00 AM,"Waynesboro city, Virginia",8546,5020,3526,51,820
01/01/2010 12:00:00 AM,"Williamsburg city, Virginia",4069,2015,2054,51,830
01/01/2010 12:00:00 AM,"Winchester city, Virginia",10221,5173,5048,51,840
